人	士	人物	人士	人氏	人選
人類	生人	全人類
人手	人員	人口	人丁	口	食指
勞力	勞動力	工作者
匹夫	個人
傢伙	東西	貨色	廝	崽子	兔崽子	狗崽子	小子	雜種	畜生	混蛋	王八蛋	豎子	鼠輩	小崽子
者	手	匠	客	主	子	家	夫	翁	漢	員	分子	鬼	貨	棍	徒
每人	各人	每位
該人	此人
人民	民	國民	公民	平民	黎民	庶	庶民	老百姓	蒼生	生靈	生人	布衣	白丁	赤子	氓	群氓	黔首	黎民百姓	庶人	百姓	全民	全員	萌
群眾	大眾	公眾	民眾	萬眾	眾生	千夫
眾人	人人	人們
人叢	人群	人海	人流	人潮
大家	大夥兒	大傢伙兒	大夥	一班人	眾家	各戶
們	輩	曹	等
我	咱	俺	餘	吾	予	儂	咱家	本人	身	個人	人家	斯人
區區	僕	鄙	愚	鄙人	小人	小子	在下	不才	不肖
老朽	老漢
小弟	兄弟
奴	妾	妾身	民女
朕	孤	寡人
職	卑職	下官	奴婢	奴才
貧道	小道
我們	咱	咱們	吾儕	吾輩	俺們	我輩	咱倆
你	您	恁	而	爾	汝	若	乃	卿	君	公
老兄	仁兄	世兄	兄長	大哥
老弟	賢弟	仁弟	兄弟
大嫂	大姐	老大姐
閣下	足下	駕	同志	老同志
陛下	主公	大王	萬歲
您老	你咯
你們	爾等
諸位	各位	諸君
他	她	彼	其	渠	伊	人家
他們	她們	他倆	她倆
自己	自家	自個兒	自各兒	自身	本身	自我	本人	小我	我	自	己
別人	旁人	他人	人家
誰	哪個	哪位	張三李四
某人	某
誰	孰	誰人	誰個	何人	哪個	哪位	何許人也
男人	男子	男子漢	男兒	漢子	漢	士	丈夫	官人	男人家	光身漢	鬚眉	壯漢	男士
爺兒	爺們	爺兒們
先生	子	君	郎	哥	小先生
女人	女子	女性	女士	女兒	女	娘	婦	婦女	婦道	婦人	女人家	小娘子	女郎	巾幗	半邊天	娘子軍	石女	紅裝	家庭婦女	農婦	才女
女流	女人家	婦道人家	娘兒們	妞兒
少婦	婆娘	婆姨	娘子	小娘子
姑娘	少女	丫頭	千金	小姐	閨女	室女	姑子	黃花閨女	大姑娘	小姑娘	童女	老姑娘	春姑娘
仕女	貴婦人	太太	夫人	少奶奶	奶奶	貴婦
賤人	禍水
村姑	農家女
男女	士女	兒女	紅男綠女	男男女女	少男少女
老人	老	老者	老漢	老翁	翁	長老	長者	遺老	耆老	叟	父	老頭兒	老頭子	老年人	老頭	老記	中老年人	白髮人	年長者
老朽	風中之燭	枯木朽株	朽木糞土
老壽星	壽星
公公	爺爺	老爺爺	老太爺	老爹	老公公	老爺子	老大爺	老人家	丈人	丈	老	老父	父老	壽爺
老奶奶	老太婆	老嫗	嫗	媼	老婆兒	老婆子	老婦
老太太	老婆婆	老大娘	姥姥	奶奶	阿婆	嬤嬤	老媽媽	老大媽
老傢伙	老糊塗
成年人	壯年人	大人	人	丁	壯丁	佬	中年人
老小	老少	大小	老幼	老老少少	白叟黃童	大大小小
青年人	青年	小夥子	青少年	後生	弟子	子弟	初生之犢	年青人	小夥	小青年	年輕人
知識青年	知青
少年人	少年	苗子	苗	年幼	未成年	未成年人
芝蘭	龍駒	千里駒
嬰兒	嬰孩	嬰	新生兒	產兒	赤子	乳兒	毛毛	小兒	早產兒	嬰幼兒
寶寶	寶貝	乖乖	囡囡	小鬼	寶貝疙瘩	寶貝兒	小寶寶
兒童	孩童	稚童	童稚	童子	孩子	孩兒	孩子家	小兒	小人兒	雛兒	幼兒	娃兒	娃娃	娃子	小子	小小子	豎子	孺子	稚子	童蒙	幼	童	孩	小	孺	囡	小朋友	小不點兒	少年兒童	童男童女	報童	少兒	小孩	小孩子	幼童	小娃	文童	伢兒	女孩兒	毛孩子	小傢伙
妞	妮子	妮兒	丫頭	黃毛丫頭	阿囡	女孩子	小妞	女童
頑童	小淘氣	淘氣鬼	孩子頭	孩子王	淘氣包
男童	男孩兒	童男
高個兒	高個子	大個兒	大個子	巨人	大漢	彪形大漢
細高挑兒	長子
矮子	矮個兒	矮個子	矬子	侏儒	小個子
胖子	大塊頭	胖小子	重者
瘦子	骨頭架子
美女	美人	姝	娥	花	媛	佳人	麗人	仙人	天仙	仙子	仙女	玉女	淑女	嫦娥	西施	尤物	嬌娃	佳麗	麗質	紅顏	紅粉	紅袖	蛾眉	嬋娟	絕色	國色	小家碧玉	傾國傾城	天香國色	國色天香	靚女	天生麗質
醜八怪	夜叉
麻子	麻臉
禿子	癩子	瘌痢頭
豁嘴	豁子	兔唇
結巴	結子	咬舌兒	大舌頭
居民	居者	定居者	居住者
市民	城裡人	城市居民	都市人
鄉民	鄉下人	鄉巴佬
船民	水上居民
僑民	僑	僑胞	華人	華裔	臺胞
本國人	國人	同胞
外國人	外僑	外人	外族	洋人
洋鬼子	鬼子	老外
外族人	外族
中國人	華人	炎黃子孫	唐人
本地人	當地人	土著	土人	土著人
村裡人	全村人
外鄉人	異鄉人	他鄉人	外地人	外省人	外來人	外族
同鄉	老鄉	鄉人	鄉里	鄉親	鄰里	鄉黨	父老鄉親	故鄉人
職工	員工
職員	幹部	員司	機關部	老幹部	高幹
公務員	勤務員	辦事員
秘書	文牘	文書	書記	文秘
總務	庶務	管事
會計	會計師	帳房	出納	出納員	先生	成本會計	大會計
掮客	經紀人	中人
從業員	營業員	售貨員	夥計	店員
列車員	乘務員	乘員
廣播員	播音員
理髮員	理髮師	理髮匠	美容師	美髮師
空姐	空中小姐
消防人	消防員
承運人	發運人
供給者	供應者
編選者	編委	編撰者
勘察者	勘探者	探索者
工人	工	工友	老工人
工匠	匠人	匠	巧手	巧匠	手藝人	藝人	手工業者
老師傅	師傅
壯工	小工
短工	零工	臨時工
苦工	苦力	勞工	雇工	勞務工
學徒工	徒工
木工	木匠
瓦工	泥工	瓦匠	泥瓦匠	泥水匠
石工	石匠
油漆工	漆工	油漆匠	漆匠	油匠
花匠	園丁	老圃	花工
畫匠	畫工	畫師
成衣匠	裁縫
鞋匠	皮匠
鐵工	鐵匠
海員	船員	水手	潛水夫	蛙人
領航員	引水員	領港	領江	航海家	引水人
船夫	船工	船家	船戶	船老大	老大	舟子	長年	水工	船東
舵手	掌舵	艄公	掌舵人
駕駛員	司機	駕駛者	車手	的哥	駝員	機手
飛行員	航空員	試飛員	空哥
宇航員	太空人
馭手	御手	掌鞭	車把式	車夫	車把勢
操作員	操縱員
搬運工	挑夫	腳夫	腳力	腳行	苦力	紅帽子
炊事員	廚師	廚子	大師傅	庖	炊事	主廚	名廚
火夫	司爐	生火	伙夫	火頭軍
郵遞員	郵差	信差	信使	綠衣使者	通信員	投遞員
交通員	交通	通訊員
聯絡員	聯絡官	連絡人
門房	號房	傳達	門子	閽者	看門人	看門	門衛	守備
服務員	招待員	夥計	侍應生	侍者	茶房	女招待	服務生
堂倌	酒家	店家	跑堂兒的	店小二
清潔工	清道夫	清掃工
勤雜工	工友	茶房	勤雜人員
農民	農夫	農	莊稼人	莊稼漢	泥腿子	農家	老鄉	村夫	莊戶人	村民	莊浪人	莊戶人
小農	老農
佃農	佃戶
上中農	富裕中農
牧民	牧人	牧工	牧女	牧戶	遊牧民
漁民	漁翁	漁家	漁夫	漁父	打魚郎
獵手	獵人	獵戶	弓弩手
樵夫	樵	芻蕘	樵姑
飼養員	倌	飼養戶
羊倌	羊工	牧羊人
放牛郎	牛郎	牧童	放牛娃	牛倌
馬夫	馬倌
屠夫	屠戶
商人	商販	買賣人	商賈	賈	商	市儈	經紀人	生意人	鉅賈	商戶	下海者
商旅	行商	行販	單幫	倒爺
小販	攤販	販子	小商	小商販	二道販子
客幫	客商	客人	客
賣家	賣方	發包方	賣主
軍官	武官	官佐	官長
指揮員	指揮官
總司令	司令員	統帥	主帥	元帥	大元帥	大將軍	主將	元戎	將帥	帥	麾下	老帥	司令	司令官
將領	將軍	大將	將	名將	武將	戰將	儒將	名將	良將	愛將
副將	偏將	裨將
虎將	猛將	闖將	驍將	梟將	飛將軍	強將	悍將
老總	長官	警官
將士	官兵	將校	指戰員
軍人	武人	武夫	兵	兵家
榮譽軍人	榮軍
邊防軍	戍邊人
士兵	兵士	戰士	士卒	兵卒	兵丁	兵員	戰鬥員	大兵	老總	兵	卒	兵油子	匪兵	老弱殘兵	精兵	卒子	新兵	小將	老將	蝦兵蟹將	兵工
女兵	娘子軍
士	軍士
步兵	陸軍
騎兵	輕騎	鐵騎	騎士
水兵	水師	水軍	海軍
偵察兵	偵察員	尖兵	探子	便衣
哨兵	衛兵	崗哨	步哨
航空兵	空軍
傘兵	空降兵
工兵	工程兵
號兵	司號員
警衛員	警衛	護兵	護衛	馬弁	親兵	衛士
通信員	勤務兵
退伍兵	退伍軍人
復員軍人	轉業軍人
老兵	老紅軍	老八路	紅軍
兵聖	戰神
官軍	官兵們
情報員	諜報員	間諜	特務	特工	特	細作	坐探	探子	眼線	眼目	耳目	資訊員	克格勃	物探	通諜
敵特	敵探	奸細
譯電員	分析員
員警	警	巡警	巡捕	警士	警官	警員	警力	軍警憲特	處警
人民警察	民警	公安人員
捕頭	警長	探長
偵探	暗探	密探	包探	警探
看守	獄卒	獄吏	警監
行刑隊	劊子手	刀斧手
審判員	審判員	陪審員	承審員	法官	推事	審判官	大法官	司法員	執法者	鐵法官	司法官
檢察官	檢察員	檢查官
律師	辯護律師	辯護士	辯士	辯護人
征稽	考稽	稅稽	稅務員
教師	老師	師	導師	師長	師資	教員	園丁	先生	教書匠	講師	教工	教職工	良師	民辦教師	教育工作者	教育者	名師
教官	教練	教練員	教頭	主教練
教養員	保育員	阿姨
塾師	師傅	老夫子	業師	夫子
學生	生	學員	學童	桃李	學習者
門生	門下	門徒	受業	學子	弟子	徒弟	入室弟子
高足	高徒	高材生	得意門生	高才生
寄宿生	住讀生	住校生
定向招生	委培生	定向生
學習者	學人
運動員	選手	健兒
裁判員	裁判	評委
醫生	醫師	醫	大夫	郎中	先生	白衣戰士	衛生工作者
國醫	中醫	中醫師
良醫	名醫	神醫
太醫	御醫
助產士	接生員	收生婆	產婆	老娘	姥姥
護士	看護	衛生員	看護者
作者	筆者	撰稿人	寫稿人	著者	起草人
執筆人	主筆
譯者	翻譯	譯員	通譯
記者	新聞記者
新聞工作者	新聞官
媒體	傳媒
編輯	編者	編輯者	編寫者	編輯家	名編輯	美編	編導者
總編輯	總編
創意者	創意人
演員	藝人	優伶	戲子	優	伶	藝員	飾演者	表演者	扮演者
明星	影星	星	超巨星	超新星	大腕
女演員	坤角兒	女星
歌手	歌姬	歌舞伎	伎	歌者	歌星	演唱者	唱工	唱頭
主角	角兒	正角兒
配角	班底	龍套	武行
名角	名伶	名優	紅角
生角	生
老生	鬚生	外	末
旦角兒	旦	花衫	花旦	旦角	名旦
青衣	正旦
彩旦	醜婆子
丑角	小丑	醜	小花臉	三花臉	金小丑
花臉	淨角	淨	架子花
大花臉	大面	黑頭	銅錘
二花臉	武二花
演職員	演職人員
表演家	表演藝術家
舞者	舞星
知名演員	名演員
琴師	樂師	樂手
鼓師	鼓手
號手	吹鼓手	吹號者
演奏者	演奏員
劇團人員	劇中人
編劇	劇作者
文藝工作者	藝術工作者
模特	模特兒
陰陽家	陰陽生
魔法師	魔術師
巫師	巫神	神巫	師公	巫	神漢
女巫	巫婆	神婆	仙姑
勞動者	生產者	小生產者
無產者	無產階級
實施者	執行者
奴隸	農奴	娃子	奚	臧
小市民	城市貧民
上訪者	來訪者
接訪	受訪者
投保人	股民
候選人	候選者	應選人
選民	選擇者	選舉人	投票者
跟隨者	追隨者	支持者	擁護者	維護者
反駁者	反對者
抗議者	示威者	遊行者
僕人	傭人	下人	奴僕	奴婢	僕役	家丁	家奴	當差	差役	雇工	傭工	公僕	孺子牛	繇
男僕	蒼頭
童僕	家童	書童	小廝	豎子	馬童	扈
女僕	僕婦	女傭	女傭人	老媽子	媽	保姆	娘姨	阿姨	女奴
婢女	婢	丫鬟	丫頭	使女	青衣	侍女	妮子
奶媽	奶娘	奶子	乳母	嬤嬤	乳娘
奴才	小人	看家狗	犬馬
僕從	長隨	跟班	跟腳	夥計
侍從	扈從	侍者
隨從	隨員	左右	隨行人員
封建主	領主
地主	二地主	莊園主	惡霸地主	田主	惡霸地主	東佃
東家	老爺	少東家
農奴主	奴隸主	雇主
士紳	紳士	鄉紳	官紳	縉
豪紳	劣紳	土豪劣紳	土豪	員外
資本家	資產階級	財閥	寡頭	大王	財政寡頭	金融寡頭	資產者	有產者	放貸人
老闆	財東	業主	小業主	老闆娘	行東
店主	店家	少掌櫃	掌櫃	甩手掌櫃
經營者	納稅人
出資人	投資人
皇帝	帝	王	上	君	天子	天皇	帝王	君王	國王	國君	君主	當今	皇上	聖上	陛下	主公	九五	九五之尊	可汗	單于	大帝	沙皇	天驕	天王	五帝	太歲	王者	至尊	統治者
女皇	女王
暴君	桀紂
皇后	王后	娘娘
妃子	貴妃	王妃	妃
貴人	後宮	嬪妃
皇室	王室	皇家	皇親國戚	宗室
太后	皇太后	老佛爺
太子	皇太子	東宮	儲君	皇儲	殿下	春宮	王儲
王子	皇子
公主	郡主
王孫	金枝玉葉	瓊枝玉葉	玉葉金枝
王公	公爵	王爺	千歲爺	親王	千歲	諸侯
貴族	萬戶侯	大公
權貴	顯貴	顯要	貴人
太監	宦官	公公	老公公	閹人
宮女	宮娥
女官	女史	女宮
官吏	臣子	臣僚	臣	官	吏	官長	官僚	官府	父母官	群臣	官兒	官宦	命官	地方官	官爵
大臣	重臣	大吏	達官	當道	大員	三九	三朝元老	高官貴爵	達官貴人	高官厚祿	鼎
芝麻官	知府	縣令
忠臣	忠良
奸臣	壞官
清官	青天	廉吏	廉者
贓官	貪官	貪官污吏	饕餮之徒
差役	公差	公人	皂隸	衙役	走卒	聽差	雜役
宰相	丞相	上相	首相	相公	中堂	尚書
秀才	生員
幕賓	幕僚	師爺	老夫子	閣僚
門客	門下	食客	篾片	幫閒	馬前卒
使者	使節	使命	使	行使	大使	行李	說者
領袖	元首	首領	首腦	主腦	法老	資政	特首
頭領	頭腦	頭子	頭目	頭兒	頭頭	把頭	大王	魁首	魁	酋	頭人	帶頭人	領頭雁	領導幹部	党首	領導人	決策人	當權者
控制者	操縱者	掌握者
領導	負責人	首長	長官	主管	主任	第一把手	官員	決策者	管理者	企業主	企業管理者	領導人員	領導者	經營管理者
領隊	總指揮	組織者	指揮者	管理員	大班	總指揮員	管理人
監工	工頭	拿摩溫	礦長	工段長	工長	帶工頭	監管者	總監
創建者	創立者	創建人	創作者	締造者	開創者	主創者	奠基人
創業者	創業人
策劃人	策劃者	規劃者
首倡者	首創者	領頭人
宣導者	倡議者	發起人	提出者
主辦人	主辦者
經辦人	經辦人員
名人	名流	名士	名家	名宿	聞人	先達	知名人士	頭面人物	風雲人物	風流人物	政要	球星	巨星	名匠	社會名流
要人	要員	巨頭	大亨	大人物
隱士	逸民	處士	山民	隱君子
小人物	老百姓	無名氏	無名小卒	無名之輩	小卒	普通人
健康人	好人	正常人	常人	平常人
病人	病家	病員	病號	患者	病夫	病包兒	藥罐子	病秧子	患兒
植物人	癱子
瘋子	瘋人	癡子	狂人	神經病
傷患	傷號	彩號	傷兵	傷病員	受傷者	傷者	受難者	傷亡者	傷殘人員
殘廢	殘缺	廢人	非人	殘疾人	傷殘人	智殘人	畸形兒
跛子	瘸子	拐子	跛腳	瘸腿
駝子	駝背	羅鍋兒
瞎子	盲人	瞍	盲童
啞巴	啞子	啞女
孕婦	妊婦	雙身子	大肚子	產婦	孕產婦
鰥寡孤獨	孤寡	孤兒寡婦
鰥夫	孤老	孤寡老人
寡婦	孀婦	遺孀	望門寡
孤	孤兒	遺孤	棄兒
孤魂	孤鬼	獨夫
光杆兒	光杆司令	孤家寡人	獨個兒	單幹戶	單人
單身漢	獨身漢	光棍兒	單身者
富翁	財主	財東	老財	闊老	大戶	大腹賈	暴發戶	富豪	豪富	有錢人	財神	財神老爺	富人	富家	大款	富人	富家	巨賈	豪商巨賈	萬元戶	巨富	百萬富翁	富商
闊少	大少爺	小開
債主	債權人
吸血鬼	寄生蟲
窮人	窮鬼	窮光蛋	窮棒子	寒士	貧民	窮骨頭	貧困者
乞丐	乞	丐	花子	叫花子	要飯的	乞討者	跪丐
債戶	負債人	借債人	債務人	欠款人	借款人
幫扶戶	保戶
閒雜人員	無聊者
幸運兒	福人	福將	福星	不倒翁	天之驕子	驕子	幸運者
紅人	寵兒	嬖	大紅人
可憐蟲	小可憐兒	叩頭蟲
無辜	俎上肉	被冤枉者
出氣筒	受氣包
甕中之鼈	網中之魚	涸轍之鮒
眾矢之的	過街老鼠	怨府	落水狗
屈死鬼	冤魂	怨鬼
被害人	受害人	事主	被害者	受害者	遇害者
當事人	當事者
冤大頭	大頭
替身	替死鬼	替罪羊	犧牲品	墊腳石
禍胎	禍根	禍端
火主	火頭
死難者	罹難者	莩
難民	難胞	難僑
災民	流民
逃亡者	逃犯	亡命
流浪漢	遊民	流民	浪人	無家可歸者	流浪者	癟三	無業遊民
敗兵	亂兵	殘兵	散兵	散兵游勇	殘兵敗將	餘部
俘虜	俘	傷俘	戰俘	活口	舌頭	囚
人質	質子	質	肉票
違反者	違者	違章人
不合格者	不符合條件者
輸家	失敗者	輸者
旅客	客人	旅人	遊子	行人	行者	行旅	客
過路人	過客
遊人	遊客	旅遊者	觀光者	港客	觀光客	旅行者	漫遊者	旅行家	度假者	遊士
乘客	司乘人員
參觀者	觀賞者
親戚	親屬	本家	親眷	六親	戚	親族	氏	親朋好友
外戚	遠房
血親	宗親
姻親	親家	遠親	葭莩	葭莩之親
眷屬	親屬	家屬	家眷	家小	老小	妻小	妻孥	骨肉	家人	家室	親人	家口	妻兒老小	妻兒	婦嬰
女眷	內眷
僑眷	僑屬
曾祖	曾祖父	老爺爺	太公	太爺	太翁	曾父
曾祖母	老奶奶	太婆
祖父	太爺	爺爺	爺	爹爹	老爹	公公	阿爹	太公	太翁	祖	老太公
祖母	奶奶	婆婆	太婆	高祖母
叔祖	叔公
叔祖母	叔婆
外祖父	外公	公公	老爺	姥爺
外祖母	外婆	姥姥	老娘	家母
父	父親	爺	爹	大	翁	爸爸	老子	爹爹	老爹	阿爹	阿爸	椿	太公	大人	爸	生父	爹地	慈父
令尊	老太爺	老爺子
繼父	後爹
養父	義父	乾爸
先父	先人
母	母親	慈母	阿媽	媽媽	媽	娘	萱	內親	生母	娘親	親娘
令堂	老太太	太君
家母	老母	老娘
庶母	姨娘
繼母	後母	後媽	後娘	晚娘
養母	義母	乾娘	乾媽
父母	雙親	二老	爹娘	爹媽	堂上	上下	椿萱	大人	上人	老人	老人家	老親	家長	考妣	父母親	養父母	嚴父慈母
保護者	保護人	衣食父母
父子	爺兒倆
伯父	伯	大伯	大爺	伯伯	大
伯母	大媽	大娘	大大
叔父	叔	叔叔	季父	表叔	堂叔
叔母	嬸	嬸母	嬸子	嬸嬸	嬸娘
姑父	姑夫	姑丈
姑母	姑	姑姑	姑媽	姑娘	姑婆
姨父	姨夫	姨丈
姨母	姨	姨兒	姨媽	阿姨	姨娘	姨婆
舅父	舅	舅舅	娘舅	小舅	表舅	大舅	郎舅
舅母	舅媽	妗子	妗
公婆	姑舅
公公	公	翁	舅	嫜	老公公
婆婆	婆母	老婆婆	阿婆	姑	婆
岳父	岳丈	丈人	泰山	岳	老丈人	娘家人
岳母	丈母	丈母娘
夫	丈夫	愛人	男人	先生	女婿	老公	漢子	當家的	人夫	那口子
老伴	老頭子	爺們	老伴兒
郎	郎君	官人	良人	夫子	夫君	夫婿	相公
妻	妻子	愛人	妻室	夫人	女人	老婆	太太	家	婆娘	婆姨	娘兒們	娘子	家裡	老小	媳婦兒	老婆子	老伴	內	內助	妻妾	愛妻	賢內助
內人	拙荊	屋裡
嫂夫人	尊夫人
髮妻	元配	大老婆	正房	前妻	糟糠	糟糠之妻	原配
填房	繼配	繼室	續弦	後妻
妾	小	姬	小老婆	偏房	側室	二房	姨太太	姨娘	陪房
夫妻	夫婦	兩口子	小倆口	老兩口	家室	終身伴侶	伉儷
鴛鴦	鸞鳳	比翼鳥	並蒂蓮	連理
配偶	偶	逑
兄	兄長	哥	哥哥	阿哥	昆	老大哥	父兄
長兄	大哥
家兄	胞兄
弟	弟弟	兄弟	阿弟	棣
堂哥哥	堂兄
師哥	師兄
兄弟	弟兄	手足	哥兒	昆仲	雁行	棠棣	小兄弟	哥們	哥倆	哥們兒
同胞	親兄弟	胞兄弟
表兄弟	老表
姐	阿姐	姐姐	姊	老姐兒
妹	阿妹	妹妹	妹子	娣	胞妹
姐妹	姊妹	姐兒
連襟	連袂	婭
嫂子	嫂	嫂嫂	大嫂	兄嫂
弟婦	弟妹	嬸	弟媳	嬸婆
姐夫	姊夫
妹夫	妹婿
妻舅	舅子	舅舅
內兄	大舅子
內弟	小舅子	婦弟
姑	姑娘
大姑	大姑子
小姑	小姑子
大姨	大姨子
子	兒子	兒	男	崽	子嗣	小子	幼子
養子	義子	螟蛉	乾兒子
繼子	繼嗣
小兒	犬子
令郎	少爺	相公	公子	哥兒
女	女兒	閨女	姑娘	丫頭	囡	幼女	姑娘家	丫	妮
令愛	千金	女公子
養女	義女
子女	兒女	孩子	男女	骨血	囡	親骨肉
心肝	寶貝	心肝寶貝	寵兒	命根子	掌上明珠	命根	寶貝兒
獨子	獨生子	獨苗	單根獨苗	獨生女	獨生子女
雙胞胎	孿生子
混血兒	混血種	雜種
媳婦	媳	婦	兒媳	兒媳婦兒	子婦	兒媳婦	侄媳婦	孫媳婦
女婿	婿	子婿	嬌客	半子	坦	倩	甥	孫女婿	侄女婿
佳婿	乘龍快婿
贅婿	招女婿
姑老爺	姑爺
侄	侄子	表侄	內侄	侄兒
侄女	表侄女	內侄女
甥	外甥
甥女	外甥女
孫	孫子	嫡孫
曾孫	重孫	祖孫
曾孫女	重孫女
外孫	外孫子
鼻祖	始祖	太祖	高祖
創始人	開山	祖師	祖師爺	元老	不祧之祖	開山祖師	老祖宗	奠基者	開拓者
前人	先驅	前驅	先驅者	先行者	先輩	前任	過來人
引進者	推薦者
今人	時人	世人	近人
一代人	當代人
後人	後代	後來人	接班人	繼承人	後任	後者	後世	傳人	子孫後代	繼任者	繼承者	來人	膝下
古人	原人	元人	原始人	猿人
祖宗	祖上	祖先	先人	先世	先祖	祖輩	上代
長輩	長上	長者	尊長	父老	老前輩	前輩	老一輩	先輩	老人	上人	老輩
父輩	大伯	伯父	老伯	世叔	叔叔	大叔	大爺	叔	爺	堂叔
大媽	大娘	大嬸
儕	同齡人
晚輩	晚	小輩	下輩	後輩	後生	後進	子弟	下一代	新一代
子孫	子嗣	兒孫	後代	後人	後嗣	後生	後裔	苗裔	裔	胄	後	裔	嗣	胄	胤	遺族	子代
受益者	受益人
朋友	友人	友好	友朋	交遊	朋	友	哥兒們	賓朋
好友	摯友	執友	密友	契友	稔友	相知	知交	知音	知心人	至交	忘年交	莫逆之交	至好	至友
舊交	舊友	舊故	故舊	舊	故人	故交	老朋友	老友	老相識
新交	新知	初交
難友	患難之交
益友	諍友	良友	良師益友	師友
世交	世誼
諸親好友	親友	親朋	親朋好友	至親好友	四座賓朋
教友	校友
恩人	恩公	救星	重生父母
仇人	敵人	仇敵	仇家	寇仇	對頭	冤家	仇	冤家對頭	大敵
死敵	死對頭	眼中釘	肉中刺
外敵	外寇
殘敵	窮寇
夙仇	夙敵	夙世冤家	宿敵
對手	對方	敵手	敵	敵方	挑戰者
自己人	知心人	貼心人	私人	近人	親信	腹心
外人	局外人	陌生人	生人	路人	第三者	閒人	異己	旁觀者	陌路
鄰居	鄰人	鄰舍	鄰里	近鄰	街坊	左鄰右舍	比鄰	東鄰西舍	老街舊鄰	鄰家	鄉鄰	遠鄰
一夥	一夥子	同夥	難兄難弟
一路貨	狐群狗黨	一丘之貉	同黨
同伴	同夥	夥伴	伴侶	伴	伴兒	侶	侶伴	儔	小夥伴
夥計	搭檔	一行	一起	同路人	旅伴	老搭檔
同道	同調	與共
合作者	合作方	合夥人
把兄弟	拜把兄弟	盟兄弟	八拜之交	同盟者
同學	同窗	同班	學友	校友	同桌	同校	同室
學長	學兄
同事	同人	同仁
同僚	袍澤
主人	主	東家	東道主	東	地主	主人公	東道	主人家	主子	莊家	東道國	主人翁
主婦	管家婆	內當家	女主人
寄主	宿主
客人	賓客	賓	客	來賓	來客
貴賓	上賓	佳賓	座上客	貴客	座上賓
男賓	男客
賓主	主客
接受方	接受者
顧客	主顧	顧主	買主	客	客官	消費者
購買者	買客	買者	買家	支付方
消費群	購買群	消費層
成員	分子	積極分子	活動分子
人馬	隊伍	原班人馬
黨徒	黨羽	徒子徒孫
私黨	死黨
上級	上司	上面	上邊	上頭	長上	上峰	頂頭上司
下級	部下	下屬	屬下	下面	下頭	僚屬	部屬	屬員	麾下	手底下	手下人	二把手
平級	同級
助手	副手	副	助理	幫辦	下手	幫手	羽翼	臂助	僚佐	左右手	膀臂	臂膀	股肱	助理員	幫廚
參謀	顧問	軍師	師爺	智囊	謀士	策士	謀臣	總參	奇士謀臣
靠山	後臺	後盾	腰杆子	支柱	後臺老闆
師傅	師父	師
師母	師娘
徒弟	徒	學徒	練習生	徒子徒孫	徒孫
物主	主人	原主	本主兒	所有者	持有人	持有者
屋主	房東	房主	二房東	房產主
收信人	接收者
寄卡人	寄信人	寫信人
主持人	主席	召集人	主持者
司儀	打理	禮賓司
與會者	到會者
演講者	講話者	發言者
專人	專差	專使	專員
特派員	全權代表
欽差大臣	欽差
代表	代辦	代理人	買辦	委託人
代言人	發言人	喉舌
見證人	見證	證人	活口	知情人	知情者
保證人	保人	保	擔保人	責任者	責任人	總負責人	行為人	責任人員	承擔者	法人
中間人	中人	中
調解人	調人	和事老	調解者
仲裁人	鑒定者	公證人	評判人	審判長	公證員
證婚	證婚人
被告人	被上訴人	被告
舉報者	舉報人	報案人
介紹人	引線人
媒人	媒介	媒婆	媒	介紹人	月老	月下老人	紅娘	元煤
男儐相	伴郎
伴娘	喜娘
仲介	仲介人
新郎	新人	新郎官
新娘	新娘子	新人	新媳婦兒	新婦	新人	新嫁娘	新娘
情人	情侶	冤家	對象	朋友	愛人	意中人	心上人	戀人	愛侶	有情人
男朋友	情郎	歡	男友
女朋友	女友
姘頭	相好	外遇
情夫	姘夫	姦夫
情婦	姘婦	姦婦	二奶
王八	烏龜	綠頭巾
英雄	豪傑	英豪	英傑	好漢	烈士	志士	梟雄	英雄好漢	英雄豪傑	民族英雄	群雄	英雄漢	群英	無名英雄	雄鷹
有志者	有志之士
硬漢	硬骨頭	大丈夫	血性漢子	猛士	硬漢子	鐵漢	勇敢者	勇者
烈士	先烈	國殤	英烈
勇士	武士	武夫	壯士	飛將軍	好樣兒的	鬥士	大力士
俠客	俠	武俠	遊俠	豪俠	豪客	義士
懦夫	膽小鬼	軟骨頭	孬種	窩囊廢	膿包	孱頭	狗熊
懶漢	懶蟲
好人	明人	良民	良	令人	本分人	良善	善人	好心人	熱心人
君子	高人	仁人君子	正人君子	仁人志士	志士仁人	謙謙君子	使君子
聖賢	聖	賢	聖人	賢人	哲人	高人	完人	賢達	賢能	賢哲	堯舜	先知	先知先覺	賢良	賢淑	醫聖	哲	鄉賢
先賢	先哲	前賢
元老	長者	泰山	泰斗	泰山北斗	魯殿靈光
壞人	歹人	歹徒	敗類	丑類	壞分子	壞東西	狗東西	癩皮狗	壞蛋	混蛋	禽獸	衣冠禽獸	無恥之徒	跳樑小丑	么麽小丑	殘渣餘孽	謬種	破蛋	鼠類
小人	小丑	鼠輩	勢利小人	阿諛奉承者
土棍	地痞	地頭蛇	惡棍	光棍	無賴	惡人	喬
惡霸	霸	霸王	土皇帝	元兇
豪強	豪門
豺狼	魔鬼	魔王	蛇蠍	惡魔	虎狼	閻羅	閻王	活閻王	混世魔王	鬼魔	魔頭
暴徒	強暴	兇殘	不逞之徒	亡命之徒
奸邪	奸人	奸宄	佞人	奸佞	妖孽	禍水	害人蟲	九尾狐	害群之馬	牛鬼蛇神
野心家	奸雄	梟雄
獨裁者	獨夫	鐵腕人物	鐵腕
老好人	好人	好好先生	菩薩	活菩薩	老實人
凶人	凶神	夜叉	饕餮	兇神惡煞
潑婦	悍婦	雌老虎	母夜叉
偽君子	假道學	笑面虎	兩面派	變色龍	投機分子	鄉願
滑頭	油子	老油子	老油條	老江湖	老狐狸	油嘴
吝嗇鬼	守財奴	看財奴	小氣鬼	鐵公雞	守財
市儈	勢利眼	勢利小人	市井之徒
造假者	弄虛作假者
孝子	孝子賢孫
逆子	孽障	業障	孽種	不肖子孫	不孝之子	不成人子
貞婦	烈女
蕩婦	淫婦	破鞋
騷貨	妖精	狐狸精	賤貨	賤骨頭
浪子	敗家子	公子哥兒	花花公子	膏粱子弟	衙內	惡少	紈絝子弟
色鬼	色情狂	漁色之徒
老頑固	死頑固	頑固派	死硬派	死心眼兒	古董	骨董	老古董
學究	腐儒	迂夫子
急性子	直性子	直腸子
炮筒子	大炮	快嘴
慢郎中	慢性子	溫吞水
話匣子	碎嘴子	貧嘴	長舌婦
應聲蟲	尾巴	傳聲筒	留聲機
饞嘴	饞貓子	饕餮
夜遊神	夜貓子
怪人	怪物	怪胎	奇人
知識份子	文化人	讀書人	先生	生員	書生	生	秀才	夫子	儒	儒生	士	士人	士大夫	文人	學子	斯文	文人墨客	文人	學士	莘莘學子	文人學士	一介書生	臭老九
文弱書生	白面書生
學者	鴻儒	大師	宗師	耆宿	名宿	老先生
作家	大作家	文豪	文宗	文學家	筆桿子	大手筆	散文家	寫家	女作家	作家群
詩人	詞人	騷人	騷客
詩仙	詩聖	詞宗
畫家	畫師
寒士	措大
書呆子	老夫子	迂夫子	書癡
文痞	文儈
文盲	睜眼瞎子	半文盲	睜眼瞎	科盲
大老粗	土包子
內行	行家	熟手	裡手	好手	老手	把勢	把式	通	一把手	快手	老資格	熟練工	內行人	行家裡手
專家	專門家	家	師	學者	大方	大家	土專家	學家
識途老馬	宿將	三朝元老	老將
骨幹	基幹	楨幹	主角	支柱	頂樑柱	擎天柱	臺柱子	柱石	棟樑	中堅	中流砥柱	台柱	棟樑之材
外行	門外漢
生手	新手
俊傑	豪傑	傑	英	豪	英豪	俊秀	英華	女傑
人傑	翹楚	魁首	狀元	高明	尖兒	尖子	超人	驥	大器	佼佼者
人才	材	材料	佳人	才子	奇才	天才	英才	千里駒	麟鳳龜龍	精英	人材	一表人材	棟樑材	有用之才	怪傑	才女	才子佳人	賢才	彥
女將	巾幗英雄	女強人
能手	能人	幹將	健將	王牌	權威	好手	上手	國手	高手	妙手	聖手	硬手	一把手	大師	宗師	大王	宗匠	巨匠	能工巧匠	名手	棋手
多面手	通才	全才	通人	百事通	萬事通
新秀	後起之秀	龍駒	新銳
庸中佼佼	強者	強手	強手如林
高才生	七步之才	鉅子
聰明人	智者	智囊	智多星	諸葛亮
明眼人	有識之士	明白人	亮眼人
機靈鬼	猴兒	鬼靈精
笨伯	笨蛋	笨人	笨貨	笨傢伙	愚人	蠢人	蠢貨	蠢材	木頭	木頭人兒	愚氓	木頭人
飯桶	草包	廢物	乏貨	朽木	二五眼	窩囊廢	酒囊飯袋	行屍走肉	朽木糞土
傻子	傻瓜	二百五	呆子	低能兒	癡子	白癡	傻帽	二愣子
庸人	庸才	凡人	凡庸	中人	平流	阿斗	匹夫	井底之蛙	凡夫俗子	等閒之輩	庸者	井底蛙
繡花枕頭	紙老虎
半瓶醋	二百五	半吊子	二把刀	萬金油
渾蛋	混蛋	妄人
活寶	寶貝	寶貝兒
糊塗蟲	糊塗蛋	馬大哈
模範	標兵	表率	榜樣	師表	軌范	楷范	英模	典型	豐碑
勞模	勞動模範
先鋒	急先鋒	開路先鋒	先行官	先遣	先行者
功臣	元勳
愛好者	發燒友
教徒	信徒	善男信女	信教者
佛	菩薩	祖師	羅漢	金剛	十八羅漢
沙門	僧尼	僧人	出家人
僧徒	僧侶	僧	和尚	沙彌	道人	行者	頭陀	高僧
尼姑	尼	姑子	師姑	仙姑	比丘尼
禪師	活佛	大師傅	大師	師父	法師	上人
住持	方丈	當家的
道教徒	道徒
道士	法師	方士	老道	妖道
伊斯蘭教徒	回教徒	穆斯林
天主教徒	天主
樞機主教	紅衣主教
神甫	神父
耶穌教徒	基督徒
反動派	反革命	反	反動分子	造反派	批鬥者
反派	反面人物
匪幫	匪徒	白匪	黑社會
劊子手	屠夫
戰爭販子	戰爭狂人	戰犯
叛徒	內奸	奸	逆	叛逆	叛亂者
賣國賊	國賊	民賊
奸賊	賊	蟊賊	獨夫民賊
兒皇帝	傀儡
罪犯	罪人	人犯	囚	囚犯	囚徒	犯人	階下囚	監犯	釋放者
死囚	死刑犯
兇犯	兇手	殺人犯	刺客	殺手
主犯	要犯	首惡	正兇	元兇	罪魁	主謀	主使	禍首	罪魁禍首	首犯	主凶
從犯	同謀犯	同案犯
逃犯	在逃犯	漏網之魚
教唆犯	教唆者
窩主	窩家
嫌疑人	疑凶
強盜	盜	寇	匪	匪徒	土匪	強人	盜匪	匪盜	盜賊	豪客	異客	歹人	胡匪	鬍子	盜寇
匪首	盜魁	草頭王
草寇	綠林	綠林好漢	草莽英雄
殖民者	殖民主義者
竊賊	賊	小偷	癟三	樑上君子	雞鳴狗盜	破門而入者
慣賊	慣竊	慣偷	慣盜
盜碼者	駭客
剽竊者	盜賣者
俠盜	家賊	飛賊	工賊
入侵者	征服者	侵略者
流氓	痞子	潑皮	光棍	無賴	兵痞	無賴漢	渣子	刺兒頭	盲流	刺頭
二流子	浪子	浪人	阿飛
騙子	拐子	騙子手	詐騙者	奸徒
投機商	奸商	黃牛党	黃牛	投機者	經濟人
毒販	毒梟	販毒者
走狗	狗腿子	腿子	鷹犬	奴才	幫兇	打手	走卒	爪牙	嘍羅	漢奸	洋奴	鷹爪
賭徒	賭棍	賭鬼	賭客
酒徒	大戶	酒鬼	醉鬼	醉漢
煙鬼	隱君子	煙民	吸煙者
妓女	妓	娼	娼妓	娼婦	婊子	花魁	神女
藝妓	搖錢樹
暗娼	私娼	野雞
男妓	相公
鴇母	鴇兒	掌班	媽媽	老鴇
龜奴	烏龜	相幫	王八
嫖客	孤老	客人	客
物	實物	東西	傢伙	玩意兒	錢物	玩意
物質	質	素
佔有物	專有物
物體	體
整體	通體
晶體	晶	結晶體	結晶	晶粒
水晶體	晶狀體
絕緣體	非導體
機體	有機體
等價物	同系物
附屬物	附著物
樣片	抽樣
硝酸	王水	硝鏹水
醋酸	乙酸	冰醋酸
燒鹼	火堿	苛性鈉	氫氧化鈉
碳酸鈉	大蘇打
硫酸銅	膽礬
明礬	白礬　
矽	單晶矽	多晶矽	結晶矽	單晶	矽單晶
硫磺	硫
蛋白腖	蛋白質	活質	乾酪素
正離子	陽離子
等離子	等離子體
生物	底棲生物	浮游生物	古生物	海洋生物	漫游生物	生物體
動物	眾生	百獸	動物群
溫血動物	常溫動物
冷血動物	變溫動物
節肢動物	甲殼動物
線形動物	圓形動物
植物	植被
陽性植物	喜光植物
作物	農作物
大秋作物	晚秋作物	秋莊稼
越冬作物	過冬作物	冬作物
青苗	青
微生物	菌物
動植物	飛潛動植	野物
物品	品	物料
必需品	用品	日用品	消費品	日用百貨
給養	補給
擺設	陳設
紀念品	紀念物	紀念	表記	留念	紀念幣
獎品	獎
雜物	雜品	什物	生財	零七八碎
古物	老古董	骨董	古玩
遺物	舊物	手澤	吉光片羽
失物	遺
證物	信物
贗品	贗鼎	冒牌貨	假貨	假冒偽劣品
抵押品	當頭	當	質
違禁品	禁製品	禁品	危禁品	違禁物品	禁藥
贓物	贓	賊贓
易燃物品	易燃物
工件	作件	製件	鑄件
部件	元件	構件	預製構件
備件	附件	配件	零配件	構配件
貨物	商品	貨	貨色	貨品
百貨	小百貨	雜貨	廣貨	日雜	小商品
下腳貨	殘貨	剔莊貨	次貨	便宜貨	犧牲品	舊貨	劣貨	餘貨	散貨
國貨	國產貨	國產品
進口貨	來路貨	洋貨	外貨	海貨	外來貨	舶來品	外國貨	進口商品
冷貨	冷凍貨
私貨	黑貨	走私貨	水貨
優質品	優等品	原裝貨
產品	出品	成品	製品	活	必要產品
粗製品	半製品	半成品	坯料	毛坯
副品	次品	等外品	處理品	殘品	劣質品	滯銷品	剩餘產品
仿製品	複製品
試用品	試製品	展銷品	新品	傳銷商品
出產	物產
水產	漁產	海產
土產	土特產	土貨	土特產品
器具	器物	用具	器	器械	家什	器材
器皿	容器	盛器
酒器	酒具
噴頭	蓮蓬頭
錨	鐵錨
電烙鐵	烙鐵
電熨斗	熨斗
消火栓	消防栓
設備	裝置	配備	裝備	裝具	設施
物資	戰略物資	軍品	軍資	生產資料
材料	料	材	材質	生料	質料
原料	原材料	原料藥
香料	香	香精
生活資料	消費資料	生活必需品
柴米油鹽	油鹽醬醋	油鹽醬醋柴
傢俱	家電	農機具	食具	燃氣具	灶具
禮品	禮物	禮	贈品	贈禮	人情	人事	儀	賜	貺	禮盒	禮金	紅包	贈物
賀禮	賀儀
薄禮	小意思	千里鵝毛	謝禮
聘禮	彩禮	財禮
貢品	貢
祭禮	賻儀
嫁妝	妝奩	妝	陪嫁	陪送
祭品	貢品	供	供品
寶物	寶貝	寶	珍	琛	珍品	珍寶	至寶	無價寶	瑰
寶	珍玩	奇珍異寶	麟角鳳觜	吉光片羽	寶中之寶	金銀財寶	無價之寶	財寶
寶藏	礦藏	富源	資源	寶庫	聚寶盆	金礦
傳家寶	家珍
廢物	廢料	廢品	破爛	破銅爛鐵	雜質	下腳	垃圾	渣滓	廢棄物	滓	渣	汙物	排泄物	污染源	垃圾堆
礦物	礦產	礦	礦體	礦物質
擔子	挑子	擔	貨郎擔
包裹	包袱	包	卷
它	她	其	它們
什麼	甚	啥	哪	何	啥子	哪門子	甚麼	何事
錠	磚
塊	丁	疙瘩	硬結	塊狀
粉	粉末	面	面子	末	末子	屑	霜	齏粉	末兒	碎末
沙	沙子
點	點子	星	星子	花	一點
粒	豆子	砟子	砟	微粒	顆粒	球粒
堆	垛	坨	坨子	簇	垛子
把	把子	捆	束	卷	紮	一小撮	括
球	團	蛋	彈	珠	丸	丸子	圓子	彈子	珠子	圓珠
輪	餅
片	片子	板	皮	片兒	片片
箔	膜	衣	箔條
草屑	木屑	紙屑
筒	管	杆	筒子	管子
洞	竅	洞窟
棒	棍	鞭	尺	條	筋
焊條	焊絲
鉤	鉤子
魚鉤	漁鉤
網	網路	絡	紗	網子	大網	羅網	發網	台網
蜘蛛網	蛛網
波	浪	脈	波形
表面波	音波	衝擊波	平面波	微波	縱波
頂	顛	峰	當	冠	梢頭
端	頭	穎	嘴	末	梢	尖	尖頭	尖子	終端	先端	末流
雞冠	雞冠子
炕頭	床頭
底	根	腳	底邊	底部	底層	底色	標底	最底層	平底	低點器底
末尾	末梢	末	梢	蒂	尾	尾巴	尾子	屁股
邊	沿	緣	四邊	斜邊	沿兒
角	棱角	犄角	一角
面	面子	皮	臉	表	表面	面上
正	正面
外表	外邊	外面	浮面	皮面	表層	表皮	浮皮兒	浮頭兒	淺表
外殼	殼	殼子
反面	背面	裡	背	陰	碑陰
側面	側	邊
南側	南端
東側	東端
北側	北端
週邊	外層
脊	棱	梁	脊樑
身	體	幹	筒
膛	腹	腔	膽
幫	壁
頸	脖
骨架	骨子	龍骨	骨	架	架子	骨頭架子
框	框子	邊框
蓋	蓋子	帽
塞	塞子
杆	梗	杆子	竿子	橫杆	竿
柄	托
把	把手	把子	耳子	襻	把兒	靠手	提手	提梁	軒轅
把手	扳手	搖手
刀把	刀柄
嘴	門	口腔
座	座子	底座	底盤	托	支座	托子	插座	燈座	寶座	礁盤	軟座	假座
腳	腿	足	發射臂	秧腳	韻腳	腳蹼	鳳爪	腳底
翼	翅	翅膀	翅子	側翼	尾翼	雙翼	翅翼	副翼	機翼
擋	柵	靶檔
心	芯	芯子
宇宙	天體	星體	天地	六合	大自然	自然界	宏觀世界	宇宙空間	宇	穹廬
星辰	星斗	星	星星	星球	星體	辰	繁星	雙星	日月星辰
星座	座	宿	星宿	二十八宿
銀河	天河	星河	河漢	銀漢	雲漢
金星	太白星	啟明	長庚	昏星	晨星	啟明星
火星	熒惑
木星	歲星
土星	鎮星
織女星	織女
牽牛星	牽牛	牛郎星
北斗星	鬥	天罡星	北斗
北極星	北辰
彗星	掃帚星	孛	哈雷彗星	白虎星
老人星	壽星
流星	賊星	客星	隕星	隕鐵	隕石
太陽	陽	日	日頭	紅日
朝陽	旭	旭日	朝日
夕陽	斜陽	殘陽	落日
驕陽	烈日	炎日	烈陽	豔陽	麗日
太陽黑子	黑子	日斑
月亮	月球	月	陰	太陰	嫦娥	玉兔	白兔	月宮	蟾宮	蟾蜍	嬋娟	玉環	月兒
朔月	新月
新月	月牙
滿月	望月	月輪
皎月	皓月	明月
日月	大明
地球	地	球
寰球	寰宇	寰
陸地	大陸	陸	洲	地	陸上	次大陸	新大陸	大洲	沂
沖	坳	山坳	山塢
低地	窪地	盆地	淤土地	低窪地
荒地	沙荒	荒野	荒原
生荒	生地	處女地
鹽鹼地	鹼地	鹼荒	荒鹼地
雪域	雪地	雪峰	雪原
原野	曠野	田野	郊野	莽原	莽蒼	沃野千里	壙
平原	平地	平川	壩子	沙場	一馬平川	沖積平原	坪
草原	草地	甸子	草甸子	草野	科爾沁
淤地	沼澤	水澤	草澤	澤國	澤	沼	沼澤地
沙漠	漠	大漠	荒漠	戈壁
島嶼	島	嶼	渚	汀	坻
沙洲	三角洲	洲	沙地
灘	沙灘	磧	壩	沙嘴	灘頭	攤床
岸	岸邊	水邊	濱	沿	湄	潯	磯	皋	岸上	坡岸	彼岸	對岸	河沿	近岸
山	山脊	山脈	山峰	嶺	岩	群山	深山	山體	支脈
青山	蒼山	翠微
高山	岳	山嶽	山陵	崇山峻嶺	小山	峻
山岡	山包	墚	岡	岡陵	岡巒	崗	崗子	土崗	山崗	突地
土山	丘	阜	土丘	土包	山丘	丘崗
巒	峰巒	山巒	疊嶂	山嶺	丘陵	重巒疊嶂	層巒疊嶂	層巒疊嶂	群峰	冰峰	分水嶺	長嶺	峻嶺	山川	山山嶺嶺	荒山野嶺	荒山禿嶺
山頂	山頭	巔	峰	峰頂	頂峰	高峰	主峰	險峰	奇峰	山上	巔峰	嵐山頭
山腳	山麓	山根	麓	陬	山嘴	山下
山脊	山梁	山腰	山巔	半山區	半山腰
山谷	穀	壑	山溝	幽谷	峽谷	低谷	谷地	河谷	崖谷	深谷	峽	山峽	山溝溝	山凹	山裡	底谷	空谷	狹谷	溝谷	穀底	原谷	雪穀
山崖	崖	雲崖	懸崖	峭壁	削壁	絕壁	懸崖峭壁	陡壁	涯
童山	禿嶺	沙嶺	荒嶺
山間	山野
西北麓	北麓	南麓
坡	斜坡	坡坡	阪
山坡	阪
緩坡	慢坡
荒山坡	荒坡
海洋	大海	大洋	滄海	海洋	溟	瀛	海域	淺海	汪洋大海	深海
遠洋	重洋
洋流	海流
大陸架	陸棚	陸架	大陸坡
內海	內陸海	陸海
瀕海	海邊	近海
江河	江	河	川	水	河流	水流	河川	長河	滄江	天塹	河水	江湖	江流	大江	沿河	河裡	延河水	江河水	地表水	大溜	濁流	淮
小河	浜	河渠
護城河	城池	城壕	城隍
岔流	汊流	港汊	汊
主流	幹流
支流	港
河床	河道	河槽	河身	主河道
河曲	流觴曲水
巨流	洪流
急流	激流	奔流
暗流	伏流	地下水
溪澗	山澗	溪流	澗	溪	溪水	小溪	細流
水溝	河溝	溝	溝渠	濁水溪	干支溝
湖泊	湖	海子	泖	澱	湖水
鹹水湖	鹽湖
池塘	池沼	池子	池	塘
糞池	化糞池
泥坑	泥潭	泥塘
潭	潭水	水潭
湖澤	湖沼
泉水	泉
噴泉	飛泉
溫泉	湯泉
瀑布	飛瀑	瀑	玉龍
廢墟	瓦礫	斷垣殘壁	殘垣斷壁	斷井頹垣	斷壁殘垣	殷墟	堞s
雨	雨水	澍
雨點	雨腳	雨幕	雨滴	雨珠
小雨	毛毛雨	牛毛雨	煙雨	細雨	濛濛
大雨	豪雨	霈	傾盆大雨	滂沱大雨	瓢潑大雨
驟雨	暴雨	雨	暴風雨	雷暴雨	疾風暴雨	大暴雨	冰暴
陣雨	雷陣雨	雷雨	過雲雨
霖雨	霖	淫雨	苦雨	淫
黃梅雨	梅雨	黴雨
喜雨	甘雨	及時雨	甘霖
雪	雪花	雪片	玉龍	鵝毛雪	冰雪	鵝毛大雪	飛雪	白雪
粒雪	雪球	碎雪	雪條
雹	冰雹	雹子	霰	風雹
冰	冰淩	淩
冰錐	冰柱	冰掛
冰塊	冰碴	冰粒
大風	疾風	狂風	暴風	扶風
颶風	颱風	強風	飆	強颱風
微風	軟風	輕風
清風	雄風
和風	熏風	暖風
寒風	陰風	冷風	朔風
熱風	焚風
東風	穀風
南風	熏風
西風	大風
北風	涼風	朔風
西南風	涼風
逆風	打頭風	頂風
旋風	羊角
信風	貿易風
狂風暴雨	暴風驟雨	疾風暴雨
淒風苦雨	苦雨淒風
過堂風	穿堂風
沙塵暴	沙暴
晚風	夜風
雲	雲彩	雲朵	雲塊
雲氣	靄
陰雲	彤雲	雲
彩雲	雲霞	雯	火燒雲
慶雲	祥雲
露	露水	露珠	寒露
嚴霜	冷霜
虹	彩虹	鱟
副虹	霓	霓虹
霞	彤雲	彩霞
煙	煙霧	雲煙
霧	霧氣	霧靄	氛
雲霧	煙靄	暮靄	嵐
雷	霹靂	霹雷	雷霆	霆	驚雷
炸雷	焦雷
閃電	電	銀線	電閃
潮汛	潮信	潮水	潮汐	汐	潮	汛
流水	清流	水流	溜	湍	湍流	白煤
洪水	洪流	洪	暴洪	山洪	大水	洪峰
深淵	淵
積水	瀝水
開水	滾水	白開水	白水	熱水	湯	沸水	涼白開
生水	涼水	冷水
泔水	米泔水
水滴	水珠
培養液	營養液
春水	綠水
汁	汁液	汁水	液	水	液汁
漿	漿液	糊	糊糊
泡	泡沫	沫子	沫	沫兒	泡泡	白沫	水花
水泡	漚
卵泡	氣泡	血泡	液泡
波浪	波	浪	浪頭	浪花
大浪	瀾	濤	怒濤	波濤	波瀾	洪波	激浪	銀山	驚濤駭浪	巨浪	浪濤	洪濤	濤瀾	驚濤	波峰浪穀
漣漪	鱗波	漪
漩渦	渦流	渦	渦旋
野火	天火	燹
篝火	營火
磷火	鬼火
火焰	火苗	火頭	火舌	火柱	火花	燈火	焰
外焰	氧化焰
內焰	還原焰	焰心
烈火	大火	活火	火海	烈焰
星火	微火	星星之火
煙火	焰火	火樹銀花
烽火	烽煙	狼煙	兵燹	戰火	炮火	火網	煙塵	烽
光	光線	亮光	光明	光耀	光華	光芒	光焰	光輝	光澤	曜	光柱	強光	光餅	焱	輝
日光	陽光	太陽	暉	昱	燁	熹
曙光	晨光	晨曦	朝暉	晨暉	晨輝	曦
落照	殘照	夕照	斜暉	餘暉	夕暉	餘輝
月光	月色	月華	蟾光
燈光	燈火
白熾	白熱
紅外線	紅外光	熱線
紫外線	紫外光	黑光	紫外
偏光	偏振光
影	影子	投影	陰影	暗影	黑影
人影兒	身影	身形	人影
背影	後影
電	電老虎
正電	陽電
負電	陰電
感生電流	感應電流
電波	電磁波
無線電波	高頻電波
磁共振	核磁共振
氣	氣體
空氣	大氣
冷氣	涼氣	寒氣	冷空氣	寒潮	寒流	冷氣團
暖氣	熱氣	熱浪	暑氣	熱流
氧氣	氧
氫氣	氫	重氫
氮氣	氮
氯氣	氯
氨氣	氨	阿摩尼亞
碳酸氣	碳酐	二氧化碳
沼氣	甲烷
電石氣	乙炔
毒氣	毒瓦斯
水蒸氣	蒸氣	汽	水汽	蒸汽	水蒸汽
氬氣	氬
氟化氫	氟利昂
顏色	色	彩	色彩	色澤	色調
淡色	素色
基色	原色	本色
冷色	寒色
補色	對比色
圖案色	廣告色
銀灰	銀灰色
氣息	氣味	氣	味	味道	鼻息
味道	滋味	味	味兒
回味	餘味
聲音	聲響	音響	響聲	聲息	響動	動靜	聲	音	響	濤	籟	聲浪	鳴響
樂音	樂聲	樂
噪音	雜訊
回聲	迴響	回音
標準音	國音	正音	國語
母音	母音	韻頭	韻腹
輔音	子音	複輔音
爆發音	破裂音
擦音	摩擦音
齒唇音	唇齒音
舌根音	舌面後音
翹舌音	捲舌音
字音	字	口齒
話音	口音	語音
方音	口音	土音	鄉音
音節	音綴
叮噹作響	叮噹
足音	腳步聲	跫然
喊叫聲	叫聲
讚揚聲	喝彩聲	讚歎聲	叫好聲
鞭炮聲	爆竹聲	禮炮聲
問候聲	祝福聲
無息	無聲無息
大聲	高聲	大嗓門
低聲	悄聲
音調	聲調	腔調	調	調	調子	調	聲腔	腔
字調	四聲
陰平	第一聲
陽平	第二聲
上聲	第三聲
去聲	第四聲
節拍	拍子	板眼	板	點子	節奏	旋律	音訊	韻律	轍口
灰塵	灰	灰土	塵埃	塵	纖塵	塵土	埃
灰燼	燼
浮土	浮塵	浮灰
征塵	風塵
煙塵	塵煙
污垢	汙	垢	污穢	污濁	污痕	污點	齷齪	骯髒	垢汙	污漬
泥垢	塵垢	油泥	皴
紋路	紋	紋理
皺紋	皺	襞	褶子	褶皺	皺褶	褶
指紋	螺紋	羅紋	指印	鬥箕	腡
痕跡	印痕	印子	痕	跡	轍	皺痕	劃痕
手印	手模
蹤跡	蹤	躅	行蹤	行跡
足跡	腳印
血跡	血印	血漬	血痕
油蹟	油漬
字跡	筆跡	墨蹟
汗斑	汗鹼	汗漬
點	點子	斑點
道子	道	道道
傷痕	創痕	傷疤	疤痕	節子
瘢痕	瘢	疤	瘡疤	疤瘌
裂痕	裂璺	裂紋
車轍	軌轍
樹木	樹	木	花木	參天大樹	椽	小樹	大樹
果樹	果木
樹林	林	森林	叢林	林海	老林	樹叢	山林	林子	原始林	密林
樹行子	林帶
松林	松樹	魚鱗松	馬尾松	迎客松	黃山松	古松	蒼松	青松	羅漢松	落葉松	雪松	油松	偃松
海松	紅松	赤松
杉	杉木
冷杉	樅	樅樹
檜	刺柏	栝
毛白楊	響楊	白楊
柳	楊柳	垂柳	垂楊柳	柳樹	柳木
河柳	旱柳
雪柳	稻樹	過街柳	水曲柳
蒲柳	水楊
紅柳	三春柳
梧桐	梧	桐
懸鈴木	法國梧桐
香櫞	枸櫞
蘇鐵	鐵樹
椴樹	河北楊
椴	菩提樹	菩提
栗	板栗
楮	構
櫟	柞樹	柞	橡	橡樹
槲櫟	槲寄生
檀	青檀	檀木
棕櫚	棕樹	棕
三角楓	椏楓
楓	楓樹	楓香樹
降香	木香
棠梨	棠	杜
山桐子	椅
珙桐	空桐樹
棘	酸棗樹	棗樹
洋槐	刺槐
泡桐	桐
枳	枸橘	金橘	桔樹	越橘
荊	荊棘
橡膠樹	橡
樟	樟木	樟樹
楊樹	小葉楊	銀白楊	鑽天楊	胡楊	黃楊	赤楊	青楊	鑽天柳
翠柏叢	古柏	翠柏	蒼松翠柏	檜柏	柏	柏樹	側柏	扁柏	松柏
榕樹	高山榕
灌木	灌木叢	沙棘	灌叢	樹莓
榆樹	榔榆	榆葉梅	榆
娑羅樹	娑羅雙樹
樺樹	白樺樹	樺
槐樹	國槐	古槐	香樟	法桐	楠	槐	紫穗槐	龍爪槐
柳杉	南洋杉	枯杉	松杉	禿杉	紅豆杉	水杉	鐵杉	油杉	雲杉	紫杉	紅杉	杉篙
常青樹	長青樹	常綠樹
椰林	椰樹林
果木林	果林
幽林	林莽	險崖老林	雜花生樹	次生林	殘次林
梔	金梔
竹子	竹	篁	筠	筇	青竹	筍竹	筱	竺	篙
毛竹	南竹
觀音竹	鳳凰竹
紫竹	黑竹	墨竹
斑竹	湘妃竹	湘竹
箬竹	箬	笪
竹篾	篾青
竹筍	毛筍	春筍	冬筍	竹茹
花	葩	英	芳	花兒	群芳
牡丹	國花	國色天香	牡丹花
菊花	菊	黃花	秋菊
荷花	荷	蓮	芙蓉	草芙蓉	蓮花
蘭花	蘭	蘭草	春蘭	草蘭
珠蘭	金粟蘭
睡蓮	子午蓮
唐菖蒲	劍蘭
梅花	梅	花魁	玉骨冰肌
紫薇	滿堂紅
木蘭	木筆	辛夷
木芙蓉	木蓮	芙蓉
山茶	茶花	山茶花
合歡	馬纓花
仙人球	仙人掌	仙人鞭
臘梅	黃梅
朱槿	扶桑
杜鵑	映山紅
月季	月月紅	月季花
丁香	紫丁香	丁香花
薔薇	野薔薇
鳳仙花	指甲花
水仙花	淩波仙子
淩霄花	紫葳
紫茉莉	草茉莉
牽牛	喇叭花
翠菊	江西臘
大麗花	西番蓮
油菜花	黃花
紫藤	藤蘿
三色堇	蝴蝶花
天竺葵	洋繡球
百合花	百合
茉莉	茉莉花
鮮花叢	花海	花球	花叢
山丹丹花	山丹
郁金	鬱金香
花卉	花草	唐花	花木
奇花異卉	名花異草	奇花異草
草	薦	卉
草叢	草莽	草甸
雜草	荒草	野草	叢雜
蓬	飛蓬
茅	白茅	茅草	茆
蒿子	蒿
沿階草	繡墩草	蒲草
鵝觀草	鵝冠草
青蒿	香蒿
藜	萊
浮萍	水萍	紫萍	紅萍
爬牆虎	爬山虎
藻	海藻	水藻	藻類
海帶	昆布
苔	青苔	苔蘚	蘚苔	苔衣
蕈	菌
銀耳	白木耳
靈芝	紫芝	芝
香菇	香蕈
蘑菇	口蘑	蘑	菇	冬菇	春菇	莪
黑木耳	木耳
五穀	莊稼	穀物	糧食作物
稻	稻子	穀	穀子	稻穀	水稻	穀類
旱稻	陸稻
麥	麥子
小麥	麥	麥子
大麥	春大麥
冬麥	冬小麥
春麥	春小麥
元麥	青稞	稞麥	裸麥
玉米	玉蜀黍	老玉米	包穀	苞米	珍珠米	棒子	棒頭	粟米	包穀	玉茭	玉米粒	紫玉米
穀子	穀	禾	粟	稷	粟子	粱
黍子	黍	稷
高粱	秫	黍	黍	粱
糜子	糜
芡	雞頭
蔬菜	菜蔬	菜	蔬
青菜	小白菜
白菜	大白菜	菘
包心菜	捲心菜	洋白菜	結球甘藍	圓白菜
球莖甘藍	苤藍	甘藍
芥菜	芥	蓋菜
花椰菜	花菜	菜花
油菜	菜
韭菜	韭	韭黃	韭芽
蔥	大蔥	小蔥	水蔥
洋蔥	蔥頭
大蔥	莞
大蒜	蒜	蒜頭	青蒜	葫
香菜	芫荽
寶塔菜	草石蠶	甘露
巢菜	野豌豆	薇
金針菜	黃花菜	黃花
金花菜	黃花苜蓿
葉甜菜	牛皮菜
銀條菜	銀根菜	銀苗
香椿	香椿頭	香椿芽
蘿蔔	萊菔	菲	小蘿蔔	白蘿蔔	蘿
胡蘿蔔	紅蘿蔔
蕪菁	蔓菁	葑
茭白	菰
萵苣	萵筍	筍子
蘆筍	石刁柏	龍鬚菜
辣椒	辣子	番椒	柿子椒	燈籠椒	甜椒	青椒	山雞椒	柿椒
番茄	番茄
南瓜	番瓜	倭瓜
黃瓜	胡瓜
菜瓜	越瓜
豆	豆子	菽	豆瓣	豆類
大豆	毛豆	黃豆
蠶豆	胡豆
赤豆	赤小豆	小豆	紅小豆
紅豆	相思子
豆莢	豆角兒	豆角
菜豆	芸豆	四季豆	刀豆
芋	芋艿	芋頭
薯	芋	薯類
甘薯	番薯	紅薯	地瓜	山芋	白薯	芋頭	木薯
馬鈴薯	土豆	山藥蛋	洋芋
豆薯	地瓜	涼薯	苕子
菊芋	洋薑
慈姑	茨菰
藕	蓮菜	蓮藕	荷藕
大棚菜	棚菜
水果	果品	鮮果
瓜果	瓜
柚	柚子	文旦
橘	橘子	橘柑	蜜橘	桔	桔子	福橘
柑	柑子	蜜柑	柑橘	柑桔	金桔	蜜桔	金橘
橙	柳丁	廣柑	香橙	臍橙
荔枝	丹荔
石榴	榴
櫻桃	櫻	山櫻桃
橄欖	青果
橄欖	洋橄欖	油橄欖
棗子	棗
黑棗	軟棗
蘋果	蘋	柰	香蕉蘋果
梨	梨子
草莓	草果	楊梅
菠蘿蜜	鳳梨	鳳梨	黃鳳梨
椰	椰子
杏	杏子	山杏
李	李子	李
獼猴桃	羊桃	楊桃	萇
五斂子	羊桃	楊桃
番木瓜	木瓜
葡萄	葡	萄	野葡萄
核桃	胡桃
山核桃	小胡桃
榧	香榧	香榧子	榧子
桃	桃子
蟠桃	扁桃
椰棗	海棗
桂圓	龍眼
柿	柿子	油柿
香蕉	甘蕉
花紅	沙果
草果	草豆蔻
肉豆蔻	肉果
銀杏	白果
香櫞	枸櫞
榛	榛子
杜梨	棠梨
栗子	栗	板栗
甜瓜	香瓜	哈蜜瓜	哈密瓜
甜棗	蜜棗
藥草	藥材	中草藥	草藥	中藥材
川芎	當歸
蘿芙木	蛇根草
大薊	薊
龍牙草	仙鶴草
木豆	豆蓉
烏梅	酸梅
南天竹	天竹
貝母	川貝
肉蓯蓉	蓯蓉
蓯蓉	列當
生地	生地黃
熟地	熟地黃
麥門冬	麥冬
蒺藜	茨
人參	參	西洋參	高麗參	丹參	黨參	紅參	苦參	沙參	太子參	土黨參	玄參	長白參	洋參
酒花	啤酒花	蛇麻
魚腥草	蕺
忍冬	金銀花
馬齒莧	長壽菜
川軍	大黃	將軍
芸香	芸
高根	古柯
鉤吻	野葛	葫蔓藤
茱萸	山茱萸	吳茱萸	食茱萸
肉桂	桂
枸杞	枸杞子
經濟作物	技術作物
落花生	花生	長生果	仁果	水花生
油菜	菜	薹
芝麻	麻
向日葵	葵花	朝陽花	向陽花	葵
蓖麻	大麻子
油瓜	油渣果	豬油果
油棕	油椰子
白蘇	荏
油桐	桐油樹	桐
桉樹	桉	玉樹	黃金樹	有加利
大茴香	八角茴香	八角	大料
桂皮	桂	桂皮樹
甘蔗	蔗
甜菜	糖蘿蔔
海棗	棗椰
蓼藍	藍
茜草	茜
紅花草	紫雲英
苜蓿	紫花苜蓿
稗子	稗
茶	茶樹	毛茶
棉花	棉	草棉
木棉	紅棉
桑	桑樹
麻	蕉
大麻	線麻
種麻	苴麻
檾麻	青麻
羅布麻	茶葉花
馬尼拉麻	蕉麻
芨芨草	枳機草
白藤	紅藤
狼尾草	草	稂
蘆葦	葦	葦子	蘆	芩	葭
馬蘭	馬藺	馬蓮
龍鬚草	蓑衣草
國產棉	國棉
上棉	優質棉
白色棉	白棉
彩棉	彩色棉
植株	株
病株	劣株
莖	本	幹	梗
稈	稈子	秫秸	棵子	萁	秸	穰	稿	莛
藤	藤子	蔓	藤蔓	藤條	蔓兒
樹幹	樹身	株	幹
花莖	畫軸	花梗
蒜薹	蒜苗
茬	蔸
麥茬	麥秸	秸稈
枝	枝子	枝條	側枝	條	柯	枝幹	主枝
枝椏	枝杈	杈子	杈	椏杈	樹杈	丫杈	枝丫
蘖	蘖枝
瘋枝	瘋杈
樹梢	杪	標	梢頭	樹冠	枝頭
柳絲	柳枝
根	根子
樹根	柢	根須
葉	葉子	葉片	箬	藿	菜葉	桑葉	樹葉	霜葉
楓葉	紅葉
花朵	朵兒	花	繁花
花蕾	蕾	蓓蕾	花骨朵	骨朵兒	骨朵	蓓
筒狀花	管狀花
花瓣	瓣	花瓣兒
花萼	萼片
花蕊	蕊	花軸
花苞	苞
花莖	畫軸
芽	胚芽	荑	嫩芽	萌
側芽	腋芽
葉芽	葉芽兒
苗	秧	栽	苗子	幼苗	秧苗	秧子	栽子	幼株	苗木	小苗
母株	母本
柄	把
果實	果子	果	實
梅子	青梅	黃梅	梅
桑果	桑葚
菱角	菱	芰
荸薺	地梨	馬蹄
果皮	中果皮	外果皮
核	內果皮	核兒
瓤	瓤子	肉	果肉	沙瓤
種子	子實	子粒	種	籽	子	實	粒	米	籽兒	籽粒
仁	種仁
松仁	松子
花生米	花生仁
蓮子	蓮蓬子兒
油菜子	菜子
芡實	雞頭米
草籽	草種
葵花子	葵花仁
牲畜	畜	家畜	六畜	畜生	三牲
役畜	力畜
牲口	餼
子畜	幼畜	崽	崽子	娃	娃子
犧牲	牲	牢
野獸	獸	走獸
猛獸	貔貅	貔	豺狼虎豹	熊	羆
狼獾	貂熊
海熊	膃肭獸	海狗	海獅
熊貓	貓熊	大熊貓	大貓熊
小熊貓	小貓熊
犀	犀牛
獾	狗獾
豬獾	沙獾	猸子
箭豬	豪豬
刺蝟	蝟
貉	貉子	狸
豹貓	山貓	狸貓	狸	狸子
河狸	海狸鼠
紫貂	黑貂
黃鼠狼	黃鼬	貔子
猞猁	林
穿山甲	鯪鯉
蝙蝠	蝠
獅	獅子	獸王
虎	老虎	大蟲	於
幼虎	乳虎	虎子	虎崽	虎仔
豹	豹子	金錢豹
象	大象
猛獁	毛象
狗熊	黑熊	黑瞎子
馬熊	棕熊	羆
白熊	北極熊
狼	狼群
狐	狐狸
赤狐	火狐	紅狐	火狐狸
玄狐	銀狐
白狐	北極狐
草狐	花面狸
猩猩	猩
猴子	猴	獼猴	猢猻	山魈
鹿	麈	鹿群
麋	四不象	麋鹿
麅子	麅
馬鹿	水鹿
麂	麂子
獐	獐子
駱駝	駝
馬	馬匹	馬兒
兒馬	駒
母馬	騍馬	牝馬
駿馬	高足	驁	駿	驥	駔	千里馬	千里駒	高頭大馬
駑馬	劣馬	駑	蹇	駘
驄	騅
馬駒子	駒子	馬駒
驢	驢子	毛驢
公驢	叫驢
騾子	騾	馬騾	驢騾
牛	牛群
公牛	牯牛	牡牛	犍牛
母牛	牛
奶牛	乳牛
耕牛	犁牛
小牛	犢	牛犢
羚羊	扭角羚
羊	羊群
公羊	羝	羯
羊羔	羔羊	羔子	羔	羊崽
頭羊	帶頭羊
羚羊	羚	劍羚
石羊	岩羊
豬	豬玀	豕	豚
毛豬	生豬	活豬
豬仔	豚	仔豬	豬苗	豬娃
狗	犬	獒
獵狗	獵犬	獫
哈巴狗	巴兒狗	獅子狗	叭兒狗
兔	兔子
野兔	野貓
鼠	老鼠	耗子
小家鼠	鼷鼠
褐家鼠	大家鼠	溝鼠
豚鼠	天竺鼠
鼴鼠	鼴
黃鼠	大眼賊
松鼠	灰鼠
鱷魚	鱷
揚子鰐	豬婆龍
鯨魚	鯨
海豚	海豬
江豚	江豬
人魚	儒艮
蛇	長蟲	群蛇
蟒蛇	蟒	蚺蛇	巨蟒
五步蛇	白花蛇
水蛇	青蛇
蛙	青蛙	田雞	蛤	蝌蚪	蛤蟆
蟾蜍	癩蛤蟆	疥蛤蟆
蜥蜴	四腳蛇
獺	水獺	海狸
海獺	海龍
禽獸	鳥獸	飛走	飛禽走獸	獸類
禽	鳥	飛禽	雛鳥	鳥類	鳥兒	小鳥	鳥雀	鳥群
猛禽	鷙鳥
隼	鶻
練鵲	綬帶鳥
鵪鶉	鶉
貓頭鷹	夜貓子	鴟鵂
鴕鳥	鴕
大鴇	鴇
鷺	鷺鷥	白鷺
鶚	魚鷹
鴻雁	鴻	雁	大雁	頭雁
雉	野雞	山雞	翟
吐綬雞	火雞
野鴨	綠頭鴨
天鵝	鵠	鴻鵠	大天鵝
烏鴉	烏	老鴰	老鴉	寒鴉	鴉
燕	燕子	家燕	雛燕	小燕子	燕兒
幾維鳥	無翼鳥
鵜鶘	淘河
極樂鳥	風鳥
喜鵲	鵲
朱頂	貯點紅
八哥兒	鴝鵒	八哥
鸕鷀	魚鷹	墨鴉
黃鸝	黃鶯
鸚鵡	鸚哥	綠衣使者
杜鵑	布穀	子規
戴勝	山和尚	呼
鵓鴣	水鴣鴣
鯤鵬	鵬
禽畜	畜禽
鷹	老鷹	鳶	蒼鷹	雛鷹	雄鷹
雀鷹	鷂子	鷂鷹	鷂	鴟
禿鷲	坐山雕	兀鷲
雕	鷲
雀	麻雀	嘉賓
金絲雀	黃鳥
鴿	鴿子
家鴿	鵓鴿
野鴿	原鴿
乳鴿	白鴿
仙鶴	白鶴	丹頂鶴
海鷗	海燕
雞	家雞
公雞	雄雞
母雞	草雞	牝雞
小雞	角雉	雛雞
筍雞	童子雞
鴨	鴨子	家鴨	鶩
鵝	菜鵝
魚	鮮魚	魚兒	魚群	魚類
魚苗	魚秧	魚花	魚秧子	魚種
淡水魚	河魚
青魚	黑鯇
草魚	鯇
鯽	鯽魚
鱖	鱖魚
鰱	白鰱
鱘	鱘魚	鮪
鯉	鯉魚
鱅	鱅魚	胖頭魚
鰣	鰣魚
鯿	鯿魚	武昌魚
烏鱧	烏魚	黑魚
鰍	泥鰍
黃鱔	鱔魚	鱔
黃魚	黃花魚	石首魚	大黃魚	小黃魚
烏賊	墨魚	墨斗魚
鰳	鰳魚	快魚	白鱗魚
鯧	鯧魚	銀鯧	平魚
柔魚	魷魚
章魚	八帶魚
比目魚	偏口魚
鯊魚	鮫	鯊
鰻鱺	鰻	白鱔	白鰻	鰻魚
大鯢	娃娃魚	鯢	小鯢
大麻哈魚	大馬哈魚	鮭魚
鱈	鰵	大頭魚
鱭	鳳尾魚
真鯛	加級魚
鮁	藍點鮁	燕魚	馬鮫魚
海龍	楊枝魚
鰨	鰨目魚	條鰨	舌鰨
鱒	鱒魚
鱸	鱸魚
魚蝦	水族	鱗甲
龜	烏龜	金龜	王八	幼龜
鱉	黿	甲魚	黿魚	團魚	王八	田鼈	鼇	鱉精
蟹	螃蟹	河蟹
梭子蟹	蝤蛑
寄生蟹	寄居蟹
蝦	蝦子
對蝦	明蝦	大蝦
蚌	河蚌
蛤蜊	文蛤	蛤	蜊	蜃
貽貝	殼菜	淡菜	貝	貝類
牡蠣	海蠣子
蚶子	蚶	瓦壟子	瓦楞子
螺	螺螄
海參	刺參
鮑魚	鰒	石決明
海蜇	蜇	海蜇頭	海蜇皮
昆蟲	蟲	蟲子
蛀蟲	蛀
幼蟲	毛蚴	尾蚴	水蠆
蟋蟀	蛐蛐兒	促織	蛐蛐
蟑螂	蜚蠊
螳螂	刀螂	螳
花媳婦	花大姐
蚯蚓	曲蟮
螻蛄	蛞螻	螻
鱟蟲	水鱉子
螢	螢火蟲
蟬	知了	寒蟬	蜩	螗
衣魚	紙魚
地蠶	地老虎	土蠶
蠐螬	土蠶	地蠶	核桃蟲
水蛭	蛭	螞蟥	馬鱉
松毛蟲	松虎
毛蟲	毛毛蟲
叩頭蟲	磕頭蟲
蜈蚣	蚰蜒
星毛蟲	梨狗
白蠟蟲	蠟蟲
星蟲	沙蟲
黏蟲	剃枝蟲
鑽心蟲	蛀心蟲
壁虎	蠍虎
蠹	蠹蟲
蠍子	蠍
蝸牛	水牛兒	蝸
絛蟲	寸白蟲
肝蛭	肝吸蟲
蛤蚧	蟶子
蜂	蜜蜂
蜂王	母蜂
馬蜂	胡蜂	黃蜂
蠶	家蠶	桑蠶	蠶寶寶
蠶蟻	蟻蠶
蠶繭	繭子
蝶	蝴蝶	蝴蝶
蛾	蛾子	飛蛾
卷葉蛾	卷葉蟲
蜘蛛	蛛蛛	蛛
棉紅蜘蛛	紅蜘蛛	火龍
蝗蟲	螞蚱	蝗	蚱蜢
蝗蝻	跳蝻	蝻子	蝻
螟蟲	螟
蚜蟲	蚜	膩蟲
棉蚜	棉蚜蟲
麥蚜	麥蚜蟲
蚊	蚊子
庫蚊	家蚊
按蚊	瘧蚊
伊蚊	黑斑蚊
孑孓	跟頭蟲
蚊蠅	蚊蟲
蠅	蒼蠅	蠅子
蟻	螞蟻	蚍蜉
臭蟲	壁虱
跳蚤	虼蚤	蚤	跳蟲
水蚤	魚蟲	金魚蟲
虱	蝨子
蜱	壁虱
細菌	菌
根瘤菌	固氮菌
抗體	抗原
菌種	菌苗
病菌	病原菌	致病菌	毒菌
病原體	病原
酵母菌	酵母	釀母菌
黴菌	黴	黑黴	毛	麯黴
醭	白醭
身體	肢體	體	身	軀	軀體	肌體	肉體	肉身	身子	身軀	軀幹	臭皮囊	人體	人身	血肉之軀	真身
形體	形骸	軀殼
全身	渾身	一身	通身	滿身	周身	遍體
上體	上身	上半身
下體	下身	下半身
屍體	屍首	屍身	死屍	僵屍	死人	異物	遺體	遺骸	屍	殍
屍蠟	木乃伊
屍骨	屍骸	骷髏	枯骨	白骨	骸骨	髑髏	殘骸	遺骨
遇難者	喪生者	死者
頭	首	頭顱	腦袋	腦瓜子	腦瓜兒	腦殼	首級	腦瓜	腦部	腦袋瓜	頭部	滿頭
白頭	皓首
額	前額	額頭	腦門子	顙	天庭	天門	腦門	腦門兒
頭頂	顛
禿頂	光頭	謝頂
腦勺子	後腦勺子	後腦勺
臉	臉盤兒	臉面	面龐	面孔	面	顏	顏面	面部	人臉	滿臉	臉部
頰	面頰	臉蛋兒	臉上	臉蛋	臉頰	臉孔	臉盤	臉龐	臉膛
頦	下巴	下頜	下巴頦兒	頷	頤
腮	腮幫子	腮頰
酒窩	笑靨	靨	笑窩
腦	腦子	腦髓	人腦
顱	顱腦	腦顱	顱腔	腦室
腦上體	松果腺	松果體
垂體	腦下垂體	腦垂體
大腦皮層	皮層	皮質
眼	眼睛	目	眸子	肉眼	雙目	雙眼	雙眸	眼眸
秋波	秋水
老視眼	老花眼	花眼
眼球	眼珠子	睛	黑眼珠	眼珠
眼白	白眼珠
眼眶	眼圈	眶	眼窩
眥	眼角
眼裡	眼底
晶狀體	水晶體
虹膜	虹彩
結膜	結合膜
視網膜	網膜
瞳孔	瞳	瞳仁	瞳人	眸子	眸
眼角膜	淚膜
耳	耳朵	耳根
中耳	鼓室
內耳	迷路
外耳門	耳孔	外耳
耳垂	耳朵垂
外聽道	外耳道
鼓膜	耳鼓
耳輪	耳郭	耳屏
鼻	鼻子	鼻頭
酒渣鼻	酒糟鼻
鼻孔	鼻腔
口	嘴	頜	咀	喙	嘴巴	唇吻	滿嘴
吻	口器	口吻	口腕
唇	嘴唇	吻	嘴皮子
兔唇	唇裂	豁嘴	缺嘴
嘴角	口角
舌頭	舌	口條
齶	上膛
喉	喉頭
咽喉	喉嚨	嗓子	嗓	吭	嗓子眼	聲門	喉管	嗓門
喉結	結喉
小舌	懸雍垂
咽	咽頭
扁桃腺	扁桃體
上頜	上顎
下頜	下巴	下顎
聲帶	音帶
牙	牙齒	齒
乳齒	奶牙
齒齦	牙齦	齦	牙床	牙花
臼齒	大牙	槽牙	板牙
智齒	智牙
門齒	門牙	大牙	板牙
犬齒	犬牙	虎牙
齲齒	蛀齒	蟲牙	蟲吃牙
釉質	琺瑯質	琺瑯
頸	頭頸	頸項	脖子	脖	領	頸部
脖頸兒	項	脖頸
肩	肩膀	肩胛	肩頭	雙肩
胸	胸臆	胸膛	膺
胸脯	脯	胸口
胸腔	腔
懷	懷抱	懷裡
心口	胸口	心坎	心窩兒	心裡
乳房	乳	奶	奶子	胸部
乳頭	乳頭
背	背脊	脊背	脊樑	脊	背部	後背
腰	腰眼	腰杆子	腰板兒	腰板	腰部	腰杆	腰肢	後腰
腹	腹部	肚子	肚皮	肚	腹腔	腹內
小腹	小肚子
肚臍	臍	肚臍眼
臀	臀部	屁股	腚	尻	臀尖
四肢	肢
臂	胳膊	胳臂	臂膀	臂膊	膀子	膀臂	膀	肱	膊	前肢	手臂	雙臂	上肢
上臂	膀子	膀臂	臂	前臂
腋	胳肢窩	腋窩	腋下	胳肢
肘	肘子	肘部	胳膊肘	手肘	肘窩
手	兩手	雙手
手掌	巴掌	手板	掌
掌心	手心	手掌心
拳	拳頭
腕	腕子	手腕	手腕子	胳膊腕子	胳膊腕子	臂腕
寸口	尺中	關上	關	尺	寸
手指	手指頭	指	指頭	指尖
大拇指	拇指	大指	巨擘	拇	擘
二拇指	食指
三拇指	中指	將指	中拇指
小拇指	小指
豬手	豬爪
腿	下肢	後肢
腹股溝	鼠蹊
大腿	股	髀
膝	膝蓋	膝頭
小腿	脛
腿肚子	腓
腿腕子	腳腕子	腳脖子
胯	襠部
腳	腳丫子	足	趾	腳丫
小腳	金蓮
扁平足	平足
赤腳	光腳板子
腳爪	爪子	爪兒	爪	爪部
腳趾	趾	腳指頭	趾頭	小趾
腳跟	腳後跟	跟	踵	後跟
腳掌	腳板	腳底板	蹠	蹯	掌	足掌
腳面	跗面
腳背	跗
蹄子	蹄
角	犄角
鹿茸	茸
羚角	羚羊角
觸角	觸鬚	鬚子	須	觸手	卷鬚
尾	尾巴	尾部
鰭	劃水
脊鰭	背鰭
翼	翅膀	膀子	翅	膀	翮	羽翅	外翼	翎翅
鞘翅	翅鞘
皮膚	皮	膚	皮層	肌膚
表皮	浮皮	面皮	外皮
眼皮	眼瞼	瞼	眼簾	眼泡
肌肉	肌	筋肉	腠
橫紋肌	隨意肌	骨骼肌
平滑肌	不隨意肌
腱	肌腱	筋腱	腱鞘	腱子
脂肪	脂	油	膏	脂膏	膏腴	膘
寒毛	汗毛
絨毛	絨	毳	茸毛	毛絨
纖毛	毫
馬鬃	鬣	鬃毛	鬃
羽毛	羽	翎	翎毛	毛	羽絨
毛氈	氈
發	頭髮	髫	毛髮	髮絲
黑髮	烏髮
小辮兒	髮辮	辮子	小辮	獨辮　辮
青絲	烏雲
髮髻	髻	鬏	纂
鬢	鬢角	鬢髮	兩鬢	鬢毛
髦	劉海
華髮	宣發	銀髮
胎髮	胎毛	奶毛
眉毛	眉	眼眉
娥眉	柳眉	柳葉眉	黛
眉心	印堂
睫毛	眼睫毛	睫
鬍子	鬍鬚	髯	須
絡腮鬍子	連鬢鬍子
骨骼	骨頭架子
骨	骨頭
骨骺	骺
頭骨	顱骨	頭蓋骨	枕骨	頂骨
顴骨	眉棱骨
肩胛骨	胛骨	琵琶骨	鎖骨
椎骨	脊椎骨	椎
頸椎	胸椎
脊	脊骨	脊樑骨	脊柱	膂	脊椎	脊索
胸骨	龍骨	腔骨
肋骨	肋巴骨	肋條	骨幹
髖骨	胯骨
髂骨	腸骨
骶骨	薦骨
股骨	髀	股骨頭
髕骨	髕	膝蓋骨	膝關節
骨節	關節	骱
椎間盤	腰椎
指甲	甲	指甲蓋
趾甲	腳指甲	爪
甲殼	甲	殼	介	厴	蓋	蓋子	殼子	硬殼
貝殼	介殼	蠡
鱗	魚鱗	鱗片	鱗屑
內臟	臟器	臟腑	髒	內
器官	官	器
五臟	五中	五內	五臟六腑
肝	肝臟	肝部
脾	脾臟
腎	腎臟	腰子	腎盂
胰	胰腺	胰子	胰島
膽	膽囊	苦膽
肫	胗
鰾	魚鰾	魚膠
感官	感覺器官
氣管	呼吸道	上呼吸道	支氣管
食管	食道
輸尿管	尿道	泌尿器
肛管	肛道
肛門	肛
心	心臟
肺	肺臟	肺部
胃	肚子	胃部
腸胃	胃腸
腸	腸子	腸管	腸道
生殖器	性器官
陰莖	小便	陽	勢
睾丸	外腎	精巢
陰部	陰戶	陰	陰門	產門	下身	下體	產道
陰道	膣
子宮頸	宮頸
胎	胎兒	胚胎
衣胞	胞衣	胎衣	胎膜	羊膜	紫河車	衣	胞
胚盤	胎盤
娘胎	胞胎
經絡	經脈	經
脈	脈絡
血脈	血管
毛細管	毛細血管	微血管
大動脈	主動脈
動脈弓	主動脈弓
靜脈	青筋	筋	筋脈	筋絡
穴道	穴位	穴	腧
脈搏	脈息
骨髓	髓
神經原	神經細胞	神經元
傳出神經	運動神經
傳入神經	感覺神經
核子	細胞核
腺	腺體
淋巴腺	淋巴結
腎上腺	副腎
前列腺	攝護腺
胸膜	肋膜
橫膈膜	膈	膈膜
瓣膜	瓣	活瓣
血液	血	血水	血流
潛血	隱血
血淋淋	血絲乎拉
抗毒血清	抗菌血清
淋巴	淋巴液
激素	荷爾蒙
汗	津	汗液	汗珠子	汗水	汗珠
痰	飲
唾液	唾	唾沫	吐沫	津液	口水	涎水	涎	津	哈喇子
奶水	乳汁	奶	乳	母乳	奶品
體液	津液	組織液
胃酸	胃液
月經	經血	經	血	精血
眼淚	淚液	淚水	淚珠	淚花	淚	涕
鼻涕	涕	泗
耳屎	耳垢	耳塞	耵聹
眼屎	眵	眼眵
頭皮屑	頭皮	頭髮屑
屎	矢	糞	便	糞便	大糞	大便
溏便	稀
尿	小便
精液	精	魚白
精子	精蟲	精
卵	子	卵子	卵細胞	卵塊
蛋	卵
雞蛋	果兒
鴨蛋	鴨子兒
蛋黃	卵黃	雞蛋黃
蛋白	卵白	蛋清
五金	金屬	大五金	小五金
鉑	白金
錫	焊錫
鋁	鋼精
金銀	金銀箔
金	金子	黃金
足金	赤金	純金	鎏
銀	銀子	白銀	紋銀	白金	足銀
銅	黃銅	銅材
紫銅	紅銅
銅線	銅絲
鋁型材	鋁材
鋼	鋼鐵	鋼材
矽鋼	矽鋼
角鋼	角鐵	三角鐵
鋼軌	鐵軌
鋼筋	鋼骨	鐵筋
鋼水	鐵水	鐵流
鐵	黑金
生鐵	鑄鐵	銑鐵
熟鐵	鍛鐵
灰口鐵	灰鐵
磁鐵	磁石	吸鐵石
鍍鋅鐵	鉛鐵	白鐵	洋鐵	鐵皮	白鐵皮
鍍錫鐵	馬口鐵	洋鐵	鐵皮
木料	木頭	木材	木	原木
枕木	道木
軟木	軟硬木	栓皮
石	石頭	石塊	石碴
閃石	角閃石
燧石	火石
螢石	氟石
木化石	木變石
鐘乳石	石鐘乳
岩石	岩	岩層
磐石	磐石	磐	巨石
礁石	礁	暗礁	島礁
卵石	河卵石	鵝卵石
矸石	矸子
石頭子兒	礫	礫石	石子	石子兒
他山石	他山之石	它山之石	山石
土	土壤	壤	泥土	土體
土堆	土牛	墩
土塊	坷拉	垡	土疙瘩	坷垃	糰粒
黑土	黑鈣土
黏土	埴	泥土	粘土	耐火黏土	熟料
高嶺土	陶土	瓷土
泥	泥巴
爛泥	稀	泥	稀泥
沙	砂	沙子	砂子	砂石	型砂	砂礫	沙礫	砂礓
沙包	沙丘	沙山	沙峰	沙柱
水泥	洋灰	士敏土	水門汀	加氣水泥	水泥塊
混凝土	砼
三合土	三和土
灰漿	砂漿
石灰	白灰	灰	生石灰	活石灰	煆石灰
熟石灰	消石灰
瀝青	地瀝青	柏油	土瀝青	木焦油
石膏	生石膏	熟石膏
磚	磚頭	甓	磚塊	磚石
碎磚	磚頭	殘磚碎瓦
耐火磚	火磚
瓦	瓦片	瓦塊
小青瓦	蝴蝶瓦
瓦壟	瓦楞
板	板子	板材	板坯
擋板	隔板
圖板	畫板	畫夾
管	管子	管材
陶管	缸管
煤	煤炭	烏金
無煙煤	硬煤	紅煤	白煤
焦煤	主焦煤
煤磚	蜂窩煤
褐煤	褐炭
炭	木炭
草炭	草煤
泥炭	泥煤
焦炭	焦
木柴	柴火	柴	薪	蘆柴	柴禾	乾柴
火煤	火撚
松明	明子
煤油	火油	洋油
石油	原油
酒精	乙醇
潤滑油	滑潤油
凡士林	礦脂
顏料	顏色	水彩
紅土	鐵丹
藍靛	靛青	靛藍
油漆	漆	漆片	漆膜
蠶絲	絲	繭絲
生絲	綃
棉紗	紗	棉纖維
化學纖維	化纖
錦綸	尼龍
滌綸	的確良
皮革	皮子	革	皮	韋	皮張
毛皮	皮桶子	皮毛
膠	膠乳	溶膠	乳膠
鰾膠	鰾	魚膠
石花膠	洋菜	洋粉	瓊脂
橡膠	皮	膠
硫化橡膠	膠皮	橡皮
粘合劑	黏合劑
玻璃	玻
毛玻璃	磨砂玻璃
有機玻璃	不碎玻璃
釉	釉料	釉子
色釉	彩釉
珍珠	真珠	珠子	珠	串珠
佛珠	念珠
玉石	玉	璧	玉佩	佩玉
寶玉	美玉	琳
象牙	牙	象牙片
金剛鑽	金剛石	鑽	鑽石
賽璐珞	假象牙	化學
吡	吡啶	有機化學
搪瓷	洋瓷
電木	酚醛	塑膠	酚醛塑料	塑
肥料	肥
化學肥料	化肥
肥田粉	粒肥
顆粒肥料	粒肥
基肥	底肥	底糞
廄肥	圈肥
油餅	枯餅	油枯
尿素	脲
氨水	氫氧化銨
複合肥	複合肥料
有機肥	有機肥料
建築	建築物	構築物
房屋	房子	屋宇	房	屋	房舍
住房	住宅	宅子	宅院	居室	廬舍	宅	齋	宅邸	廬
樓房	大樓	樓臺	樓宇	樓	樓堂館所	平地樓臺	樓群	樓面	樓層
城樓	箭樓	角樓
鼓樓	鐘樓	譙樓	塔樓
大廈	高樓	摩天樓	高樓大廈	摩天大樓	摩天大廈	巨廈	廈
廣廈	深宅大院
宮殿	宮	殿
紅樓	雕樑畫棟	亭臺樓閣	亭台樓榭
小屋	蝸居	寮	斗室
草屋	茅屋	茅舍	茅廬	草堂	庵	蓬門蓽戶	草房	草棚	茅棚	茅草屋
棚子	棚	廠
窯	窯洞
故居	故宅	舊居	舊宅	老宅	祖居	古堡
商業樓	商住樓	商品房	商客居
民居	民宅	家宅	私宅
居民樓	單元樓	住宅樓	住宅房	家屬樓
危樓	危房	危舊房	危陋平房	拆遷房
城堡	城建	堡	塢
茅草房	草房子
別墅	山莊
公館	官邸	私邸	府第	府邸	府	宅第
房間	屋子	室	間	房	房室
裡屋	里間
外屋	外間
臥室	臥房	寢室	內室	起居室
廳	大廳	正廳	廳堂	客廳	廳房	客堂	會客室	廳子	宴會廳
飯廳	餐廳	食堂	飯堂	餐房
正房	上房	堂屋
廂房	廂	包廂
廚房	灶間	灶	庖廚	伙房	廚
廁所	廁所間	廁	便所	茅坑	茅廁	茅房	洗手間
衛生間	盥洗室	更衣室
門房	傳達室
書房	書齋	書屋
教室	講堂
藏書室	藏書樓	圖書館
錄音室	錄音棚
地下室	地窨子	地窖	窖
新房	洞房
閨房	閨閣	深閨	繡房	內宅	閫
公堂	大堂	堂	大會堂
會客廳	接待廳
展室	展廳
單間兒	單間
影廳	電影廳	錄影廳	放像廳	演播廳
門	門戶	闥	戶	闔
旁門	側門	邊門	角門	腳門
宮門	閽
閻	閭
柴門	柴扉
門扇	扉
門閂	閂	扃	釕銱兒
門環	獸環
門檻	門檻
窗	窗子	窗戶	軒	牖	窗扇	窗牖
窗臺	窗沿
窗框	窗櫺
門窗	窗門
門面	門臉
地基	基礎	根腳	根基	地腳
地面	地
天花板	藻井
梁	檁	桁	檁子	椽子	欒
正樑	脊檁	大樑	棟	屋脊	屋樑	房梁
柱	柱子	柱頭	支柱	柱身
樁子	樁
牆壁	牆	壁	垣	堵
城牆	城垣	城郭	關廂	城廂	城	墉	城垛
箭垛子	雉堞
照壁	照牆	影壁	蕭牆
夾層牆	夾牆	夾壁牆
山牆	房山
防火牆	風火牆	擋風牆
圍牆	牆圍子	圍子
隔斷	隔扇
殘牆斷壁	斷壁
長城	萬里長城
籬笆	籬	藩籬	樊籬	籬落	笆籬	綠籬	花障	籬牆
柵欄	柵	籬柵
屋簷	房檐	雨搭
簷	簷子
水溜	檐溝	天溝	水落管	雨水管
排水溝	溝	下水道	排汙溝
陽溝	明溝
陰溝	暗溝	滲溝
陽臺	平臺	曬臺	涼臺	樓臺
院子	院落	天井	庭	庭院	小院
走廊	廊	廊子	過道	走道	甬道
臺階	踏步	階	級	砌	除	墀	陛	坎	階級	坎兒	坎子
石級	石階	石坎	磴	階石
樓梯	梯	階梯	梯子
繩梯	軟梯
欄杆	闌幹	檻	欄
路	道
馬路	街道	街	大街	逵
人行道	便道	走道	便路
胡同	弄堂	里弄	閭巷	巷	巷子	街巷
小街	小巷
橋	橋樑	大橋	圯
懸索橋	吊橋	索橋
開合橋	活動橋
旱橋	天橋
過街橋	過街天橋
田地	土地	田畝	田	大田	地	莊稼地	田疇	疇	農田	耕地	糧田
良田	肥田	高產田	米糧川	沃土	沃野	沃田
休耕地	休閒地	白地
旱地	旱田
水地	水田
承包田	承包地
田間	田裡
熟荒	廢耕地
田埂	埂子	阡陌	阡	陌	墊	壟	田壟	塄
園圃	園	園子	園田	圃	田園	庭園
溫室	暖房	花房	大棚	溫室群	暖棚	保暖棚	溫棚
苗床	溫床	冷床	陽畦
圈	欄	牢	囿	苑	櫳	廄	棧	舍	棚	棚圈
豬圈	豬舍
馬廄	馬棚
籠	柙	檻
窠	窩	塒	巢	窩巢	窩窩
蜂巢	蜂窩
鳥窩	鳥巢
陷阱	陷坑	阱
水庫	蓄水池	塘堰	塘壩
堤壩	水壩	壩子	堤岸	堤防	壩	堤	防	防水壩	堤堰	大壩	堤坡	堤圍	岸防	坪壩	澇壩	拱壩	海堤壩	攔海大壩	河壩	河堤	大堤	堤埂
圩子	圩垸	子墊	垸	圩
水閘	閘	斗門	閘門	閘室
溝渠	溝	渠	管道	水道	水渠	地溝	溝槽	渡槽	壟溝
溝溝壑壑	千山萬壑	溝溝坎坎	溝壑
井	水井
機井	管井	洋井
礦井	豎井	立井	斜井
坑道	巷道	平巷	礦坑	窿
工作面	掌子
發電站	發電廠	電站
火電站	熱電廠	火力發電廠
倉庫	倉	庫	棧	倉房	庫房	儲藏室	堆房	棧房	堆疊	貨棧
糧倉	穀倉	倉廩	糧庫	糧囤	站
營房	營	寨	營寨	軍營	兵營	營盤	老營	兵站
堡壘	壁壘	營壘	碉堡	地堡	橋頭堡	碉樓	礁堡
掩體	掩護	掩蔽體
鹿砦	鹿角
壕溝	戰壕	壕	塹壕
園林	公園	花園	莊園	園	苑
御花園	御苑
陵園	烈士陵園
花壇	花池子	花圃
草坪	草地	綠地	青草地	綠茵
塔	寶塔	浮屠
象牙之塔	象牙塔
亭	亭子
閣	樓閣
舞臺	戲臺
講臺	講壇
月臺	月臺
墳墓	墳塋	墓葬	陵墓	陵	丘	塚	墳	墓	墳丘	丘墓	青塚	墓塋
陵寢	山陵	寢
墳頭	墳山
墓道	神道	墓場
祖墳	祖塋	祖陵
墓穴	穴	窀穸	壙
碑	碣	碑碣	碑石	石碑
墓碑	墓表	神道碑
皇宮	王宮	宮殿	宮闕	宮室	宮廷	宮闈	建章	宮	殿	禁	闕	宮苑	宮內
祠堂	宗祠	祠	廟
太廟	宗廟
佛殿	殿	殿堂
廟宇	廟	廟舍
孔廟	聖廟
寺	寺院	佛寺	禪林	禪房	刹	寺廟	寺觀	禪寺
庵	尼姑庵
觀	道觀
本寺	該寺
教堂	禮拜堂	天主教堂	主教堂
機器	機	機械	機具
農機	農械	農機具
工作母機	母機
蒸氣機	汽機	蒸汽機
內燃機	熱機
摩托	摩托車	機車
發動機	動力機	引擎
柴油機	狄塞耳機
發電機	電機
電動機	馬達	電機
汽輪機	汽機
渦輪機	輪機	透平機	水輪機
燃氣輪機	氣輪機
起重機	吊車	龍門吊	塔吊
升降機	電梯
天車	行車
鑽探機	鑽機
鑿岩機	風鑽	風鎬	電鎬
水壓機	油壓機	液壓機
織布機	機子	機杼	紡紗機	紡車	紡機	紡織機	細紗機
捲揚機	絞車
掘土機	電鏟	推土機	挖掘機	掘進機
聯合收割機	聯合機	康拜因	收割機
拖拉機	鐵牛
鏟土機	鏟運機
鼓風機	吹風機	通風機	送風機	暖風機	抽氣機
壓路機	軋機
電腦	電腦	微處理機	微電腦	微機	微型機	微處理器	處理器
輸送機	輸機
老虎機	賭博機
電子遊戲機	遊戲機	遊藝機
彩電	彩色電視
櫃員機	櫃機	提款機
內記憶體	記憶體
空調機	空調
烤箱	烘箱
家用電器	家電	小家電
放映機	放像機
工具	器	傢伙	家什
泵	唧筒
水泵	抽水機
氣泵	風泵
氣筒	打氣筒
機床	床子
車床	旋床
衝床	衝壓機	壓力機
刀具	刃具
機件	器件	零件	元件	零部件
雷射器	萊塞
化油器	汽化器
絞盤	轆轤
滑輪	滑車
飛輪	飛
齒輪	牙輪
滾珠軸承	球軸承	滾柱軸承	滾動軸承	滾針軸承	滑動軸承	軸承	空氣軸承
滾珠	鋼珠
主軸	主光軸
傳動帶	皮帶
鎖鏈	鎖	鎖頭
彈簧	繃簧	簧	簧片
發條	弦
合頁	合葉
閥	閥門	凡爾	活門	截門
活塞	鞲韝	活塞環
軸瓦	軸襯
銷子	銷釘	開口銷
離合器	靠背輪
排擋	擋	風擋
履帶	鏈軌
輪軸	軸心	連軸	凸輪軸	滾軸
空氣錘	氣錘
蒸汽錘	汽錘
劈	楔子
筘	杼
釘子	釘
螺釘	螺絲	螺絲釘
螺母	螺絲母
螺紋	螺絲扣
地腳螺絲	地腳螺栓
錠子	錠
紗錠	紡錠
制動器	閘	刹車
梭	梭子
鑰匙	匙	鑰
撞鎖	碰鎖	碰簧鎖	彈簧鎖
拉鍊	拉鎖	拉鎖兒
鐵鎖鏈	鋃鐺
零備件	附配件
電子器件	元器件	電子元件
轉子	鏇子
步話機	步談機	步行機
電話機	機子	全球通	公用電話	電話	對講機	話機	有線電話
電唱機	唱機
留聲機	話匣子	唱機
收音機	無線電
電視機	電視
幻燈機	幻燈
受話器	耳機	聽筒
發話器	話筒
微音器	送話器	傳聲器	麥克風	話筒	喇叭筒
揚聲器	喇叭	音箱	組合音響	擴音機
拾音器	電唱頭
電子管	真空管	燈
繼電器	替續器
容電器	電容器
兩極管	二極體
原線圈	初級線圈
副線圈	次級線圈
呼機	尋呼機	傳呼機
手機	大哥大	部手機	無繩電話機	無繩話機	無繩機	無線電話
電視電話	可視電話
電線	電纜
橡皮線	皮線
電料	電器
電池	乾電池	電池組
蓄電池	電瓶
開關	電門	電鈕	電鍵
插頭	插銷
電閘	閘	閘刀
光電池	太陽電池
農具	耕具
鐮刀	鐮
鋤	鋤頭	耘鋤	耨
耙	耙子	釘耙	釘齒耙	耙犁
犁	犁頭
鏵	犁鏵
耬	耩子
耮	耱	蓋
筢	筢子
水車	翻車	龍骨車
戽鬥	戽
風車	扇車
碌碡	滾子	石滾
漁具	魚具	釣具
魚網	罟	罨	罾
魚漂	浮子
磨子	磨盤	磨	礱
碾子	碾
碓	石碓
蠶箔	箔
蠶簇	山
錛	錛子
螺絲攻	絲錐
叉	叉子
篩	篩子	羅	濾器
漏斗	漏子	濾鬥
扳子	扳手
釺子	釺
砂紙	砂布
千斤頂	千斤
磨刀石	礪石	油石	硎	砥
砂輪	砣子
刀	刀子	刀片
鍘刀	鍘
鏨刀	鏨
剃刀	剃頭刀
剪	剪刀	剪子
斧	斧頭	斧子
刃	口	鋒	刀鋒	刀口	刀刃	鋒刃	刃兒	刃片
錘	錘子	榔頭	槌	椎	榔
鎬	鎬頭
洋鎬	鶴嘴鎬	丁字鎬	鐵鎬
鑿	鑿子	鏨子	鏨	雕鑿
冰鑹	鑹子
鍬	鐵鍬	鍤
鏟	鏟子	鏟刀
刨	鉋子	刨刀
鋸	鋸子
銼	銼刀	銼子
板銼	扁銼
鉗	鉗子	鋏
鑷	鑷子
夾	夾子
老虎鉗	虎鉗	臺鉗
火鉗	火剪
錐	錐子
改錐	趕錐	螺絲起子	螺絲刀
棒	棒子	棍	棍子	杖	大棒	棒槌	棍棒	棍兒	梃子
通條	火棒
木棒	木棍
鐵棍	鐵棒
擀杖	擀麵杖
杠	杠子	杠棒
扁擔	擔子
墩子	墩
砧板	案板	俎	椹
砧	砧子
模具	胎具
模型	模子	模	型	範
坯	土坯
坯子	磚坯
範本	沙盤	模版
銅模	字模	字樣
楦子	楦
夾具	卡具
榫頭	榫子	榫
雕版	梓
紙版	紙型
版心	頁心
套版	套色版
活版	活字版
儀錶	儀器	儀	計	表
電流計	安培計	電流錶
電錶	電度錶
電壓計	伏特計
溫度計	溫度錶	寒暑表
體溫計	體溫表
指南針	南針	司南	羅盤
渾天儀	渾儀	渾象	天球儀
水準器	水準
圭表	圭	圭臬
測試儀	探測儀
流量計	流量表
尺	直尺	尺子
丁字尺	丁字規
表尺	尺規
三角尺	三角板
曲尺	矩尺	魯班尺	角尺	矩
計算尺	算尺
遊標卡尺	卡尺
弓	步弓
秤	衡器	銓	枰
磅秤	臺秤	案秤	磅	地磅
秤錘	秤砣	砣	權	夯砣
秤毫	毫	秤紐
鬥	斛
爐子	火爐	爐	火爐子
灶	爐灶	鍋灶
高爐	鼓風爐
馬丁爐	平爐
火油爐	煤油爐
聽診器	聽筒
注射器	針
金針	針
脫脂棉	藥棉
橡皮膏	膠布
拐杖	拐棍	拐	杖	手杖	雙拐	拐棒	拄杖
月經帶	衛生帶
車	車輛	車子	輿	軫
機車	火車頭
火車	列車
轎車	臥車	小車	小轎車	小汽車
自行車	腳踏車	單車	車子
賽車	跑車
篷車	棚車
敞車	敞篷車
悶子車	悶罐車
斗車	罐
鏟車	鏟運車	叉車
人力車	洋車	東洋車	黃包車	膠皮
手推車	手車	小車
大板車	排子車
平板車	三輪兒
大車	輅
拖車	掛斗	掛車
班車	交通車
靈車	柩車	殯車
車駕	鳳輦	輦	駕
船	船舶	船隻	舟楫	舟	艇	舫	輪	舡	船兒
小船	扁舟	劃子	小艇	舴艋
舶	舸
郵輪	郵船
遊船	遊艇
汽艇	快艇	摩托船	電船
渡船	擺渡
渡輪	輪渡
救生艇	救難船
舢板	三板
拖輪	拖船
龍舟	龍船
皮划艇	皮艇
筏子	筏	桴
木筏	槎
排筏	排
飛機	鐵鳥	機	飛行器
飛艇	飛船
轎子	轎	輿
花轎	彩轎
雪橇	扒犁	冰橇	冰床
舵	艄
槳	橈	棹
帆	篷	船篷	風帆
桅杆	桅	檣	桅檣
艙	廂
車把	把	龍頭
方向盤	舵輪
車輪	輪子	輪	車軲轆	軲轆
輪胎	輪帶	皮帶	胎	車胎	車帶
外胎	外帶
內胎	裡帶
鞍	鞍子
轡	轡頭
籠頭	羈
馬鞍	馬鞍子
馬掌	馬蹄鐵
鞭子	鞭	策
武器	火器	軍火	軍械	器械	戰具	兵戎	兵器	甲兵	兵	鐵	械	刀兵	刀槍	槍炮	槍桿子	傢伙
原子武器	核子武器	核武器	核軍備
槍	槍支	槍械
步槍	大槍
盒子槍	駁殼槍	盒子
機關槍	機槍
炮	火炮	大炮
無坐力炮	無座力炮
火箭炮	喀秋莎	火箭筒
瞎炮	啞炮
刺刀	槍刺	白刃
彈藥	彈
槍彈	子彈	槍子兒
燃燒彈	燒夷彈
榴霰彈	子母彈
氫彈	熱核武器
霰彈	群子彈
飛彈	流彈
彈頭	彈丸
彈殼	藥筒
手榴彈	手雷
炸藥	火藥	藥
梯恩梯	黃色炸藥
弓	弩弓	弩
箭	矢
響箭	鳴鏑
暗箭	暗器	袖箭	毒箭
箭頭	箭鏃	鏑	鏃
箭靶子	靶子	箭垛子	鵠的	的	鵠	臬
矛	長矛	鎩	鈹	戛
槍	長槍
盾	盾牌	藤牌	幹	櫓
印尼盾	印尼盾
劍	寶劍	鋏	幹將	龍泉
短劍	匕首
尚方寶劍	尚方寶劍	尚方劍	上方劍
軍艦	兵艦	艦	艦艇	兵船	戰艦	艨艟	艦船	艦隻	艦群
戰列艦	戰鬥艦	主力艦
護衛艦	護航艦
潛水艇	潛艇
炮艇	護衛艇
戰鬥機	殲擊機	驅逐機
主機	長機
坦克	坦克車
裝甲車	鐵甲車
火箭	運載火箭	運載工具
紙牌	葉子
骨牌	牙牌
撲克	撲克牌
麻將	麻雀
色子	骰子
旱煙袋	煙袋	煙袋鍋	旱煙管
水煙袋	水煙筒	水煙斗
煙斗	煙嘴兒
刑具	大刑
鍘刀	鍘
鐐	腳鐐	桎
銬	手銬	梏
鐐銬	桎梏
燈	燈火	亮兒
日光燈	螢光燈	白熾燈	白熾電燈
檯燈	桌燈
汽燈	保險燈
本生燈	煤氣燈
馬燈	桅燈
風燈	風雨燈
油燈	燈盞	青燈
燈籠	紗燈
手電筒	電筒	電棒	手電筒
電燈泡	燈泡	泡子
燈罩	燈傘
燈心	炷
燈檯	檠
鏡子	鏡	鑒
凹面鏡	凹鏡
凸面鏡	凸鏡
凹透鏡	發散透鏡
凸透鏡	放大鏡	會聚透鏡	火鏡
三棱鏡	棱鏡
眼鏡	鏡子
透鏡	鏡片
墨鏡	茶鏡	太陽眼鏡	太陽鏡
花鏡	老花鏡
望遠鏡	千里眼
接物鏡	物鏡
接目鏡	目鏡
刷	刷子	抿子
帚	掃帚	笤帚	彗	掃把
雞毛撣子	撣子	撣帚
拖把	墩布
毛巾	手巾	巾	冪
手絹	手巾	手帕	帕	巾帕
頭帕	頭巾
肥皂	胰子	梘	洋堿
梳子	梳	篦子	櫛	攏子	木梳	梳篦
針	金針	引線	縫衣針	鋼針
針鼻兒	針眼
頂針	針箍
線	縷
絲線	絨線	綸
毛線	絨線	頭繩	絨頭繩
線桄子	線軸兒
針線	針頭線腦
鍋	釜	煲	鑊	鑊子	鼎	鍋子	鼐
火鍋	一品鍋
平底鍋	鐺
高壓鍋	壓力鍋
壺	銚
便壺	夜壺
蒸籠	籠屜	籠	屜子	甑子	圓籠	箅子
勺子	勺
舀子	水瓢	水舀子	瓢
匙子	匙	羹匙	調羹
筷子	筷
盆	盆子
缽	缽頭	缽子
缽盂	缽
缸盆	瓦盆
澡盆	浴盆
痰盂	痰桶
馬桶	恭桶	便桶	馬子	糞桶	抽水馬桶
瓶	瓶子
冰瓶	保溫瓶
暖水瓶	保溫瓶	熱水瓶	暖瓶
花瓶	花插
吊瓶	輸液瓶
盤	盤子
碟	碟子
杯	杯子	盅	盅子	盞	海
酒杯	酒盅	觴	白	觥	觚	樽
罎子	壇	甕	甏	瓿
酒罈	埕
罐子	罐	罐頭
儲存罐	儲罐
缸子	缸
箱	箱子	箱籠	篋
書箱	笈
信箱	郵箱	信筒	郵筒
竹箱	簏
提箱	手提箱
果皮筒	果皮箱	垃圾箱	垃圾桶
保健箱	急救箱
舉報箱	信報箱	信報箱群
盒子	匣子	盒	匣	匭	函	櫝
煙盒	香煙盒
音樂盒	八音匣子
暗盒	黑匣子
籃	籃子	籃筐	提籃
簍	簍子	簏
背簍	馱簍
籠	籠子
籮筐	籮	筐	筐子
淘籮	筲箕	淘米籮
笆斗	栲栳
簸箕	畚箕
糞箕子	糞筐
提包	手提包	手提袋
麻包	麻袋
沙包	沙袋
錢包	皮夾子	腰包	皮夾
袋	袋子	口袋	荷包	囊	橐	兜	兜子	兜兒
網袋	網兜	絡子
紙口袋	紙袋
背搭子	褡褳
套	套子	筒	封套
鞘	韜
書套	書函
被套	被袋
滾輪	虎伏
浪木	浪橋
拉簧	擴胸器	拉力器
杠子	杠
球	球類
乒乓球	檯球
康樂球	克郎球
球拍	拍子
彈子	檯球
棋	棋子	棋類
棋盤	圍盤
樂器	法器
打擊樂器	響器
絃樂器	絲弦
古琴	七弦琴
三弦	弦子
二胡	南胡
揚琴	洋琴
六弦琴	吉他
阮咸	阮
簫	洞簫
排簫	參差
笙	參差
笛	笛子	橫笛
號	喇叭
號角	角
小鑼	鐋鑼
鼓槌	桴
拍板	鼓板	檀板	板
老弦	裡弦
子弦	外弦
幕	幕布	帷幕
佈景	景
照相機	相機
攝影機	錄相機	攝像機
膠片	軟片	膠捲
影片	片子
拷貝	正片
底片	底版	底板
正色片	分色片
文具	文房四寶	筆墨紙硯
印泥	印色
印臺	列印台
信封	封皮
圖釘	摁釘兒
糨糊	糨子	麵糊	漿糊
鋼板	謄寫鋼版
筆	筆桿
毛筆	毫	水筆	聿
鋼筆	自來水筆	金筆	水筆
圓珠筆	原子筆
筆套	筆帽
筆鉛	筆心	筆芯
墨	松煙墨
墨汁	墨水
紙	紙張	紙頭	箋	楮
報紙	白報紙	新聞紙
宣紙	宣
玉版紙	玉版宣
稿紙	原稿紙
信紙	信箋	箋
吸墨紙	吸水紙
手紙	草紙	衛生紙	廢紙	衛生巾
硯	硯臺	硯池
簿冊	簿子	簿	冊	本	本子	冊子	簿籍	小冊子
表冊	表
筆記本	筆記簿	記錄本	記錄簿
帳簿	帳本	簿記	帳冊	帳	帳冊	帳本
名冊	人名冊	花名冊	名單	錄	榜	譜
戶口名簿	戶口冊	戶口本
摺子	折	奏摺
食譜	菜譜	菜單	菜系
聘書	聘約
卡片	卡
承諾卡	保證卡	信譽卡	信用證
名帖	名片	片子	刺	手本
帖	柬	柬帖
請帖	請柬	禮帖
黑帖	無名帖
單據	票據	單子	單	契據	契約	字據	字	票	票子	券	票證
借條	借據	左券
收條	收據	收執
存執	存根	票根	存摺
發票	發單
保單	保單	包票	保票
結	保證書	軍令狀
提單	提貨單	貨票
門票	入場券
站臺票	月臺票
往返票	來回票
免票	贈券	招待券	紅票
證書	證明	證明書	證件	證	關係
路條	路簽	通行證
文憑	畢業證書
執照	照	許可證	證照
行車執照	駕照
合格證	合格證書
憑證	憑據	憑單	證據	憑信	符	信物
虎符	兵符
標誌	標記	標示
牌子	牌	標牌
路牌	指路牌	站牌
籌碼	籌	碼子
籤子	簽
封條	封皮
幛子	幛
匾	匾額	牌匾	橫匾
橫幅	橫披
界樁	樁子	界石	界碑
令箭	令旗
旗幟	旗子	旌旗	旗	幟	旆	旄	幡	幢
軍旗	麾
招子	幌子	市招
旗杆	杠
圖章	印章	戳兒	戳記	手戳	圖書	圖記	鈐記	印信	關防	章	印	篆	璽	印鑒
徽章	證章
帽徽	帽章
袖章	袖標	臂章
蠟燭	燭	蠟	炬	火燭
蠟臺	燭臺
香燭	香火
火柴	洋火	自來火
火把	火炬	炬
紐扣	紐	扣兒	紐子	扣子	衣扣	鈕扣
子母扣兒	摁扣兒
襻兒	紐襻
結	結子	扣	扣子	疙瘩	結兒
活結	活扣
死結	死扣
繩	索	纜	紼	繩子	繩索	纜索
韁繩	縶	韁
鋼索	鋼纜	鋼絲繩
鏈	鏈子	鏈條
帶	帶子	絛	絛子	纓
彩帶	彩練
綬帶	紱
腰帶	褡包
腿帶	綁腿
吊帶	吊襪帶	襪帶
桌子	檯子	案子	桌	台	案	幾
方桌	八仙桌	四仙桌
圓桌	圓臺
書桌	書案	寫字臺	辦公桌	一頭兒沉	桌案
梳粧檯	鏡臺
條案	條桌	條几
抽屜	抽斗	鬥	屜子
椅子	椅	交椅
圈椅	安樂椅	扶手椅
凳子	凳
長凳	條凳
床	榻	鋪	床鋪	床榻	枕席	臥榻
行軍床	帆布床
木床	板床
病床	病榻
櫥	櫃	檔	櫃子	櫥櫃	櫃櫥	箱櫥
碗櫥	碗櫃
衣櫥	衣櫃
床邊櫥	床邊櫃
保險櫃	保險箱
欄櫃	攔櫃
屏風	屏
臥具	寢具
被褥	鋪蓋	鋪墊	鋪陳	鋪蓋卷
被子	被臥	被頭	被	衾
棉絮	棉花胎
褥子	墊被	褥套	茵
草墊子	草薦	稿薦
毯子	毯
枕頭	枕
床單	褥單	單子	被單
帳子	蚊帳	帷	幬
席子	席	衽席	涼席	踅子
篾席	竹席	簟	席篾
草席	薦	蘆席	席草
簾子	簾
幔	幔帳	帷子	帷子	帷幔
窗簾	窗幔	窗帷	簾幕
帳幕	帳篷	幕	篷	帷幄	帷幕	蒙古包	氈包	氈幕
墊子	墊	墊片	藉
罩子	罩	護罩
奶罩	胸罩	乳罩
面罩	面紗
鐘	時鐘	鐘錶
座鐘	臺鐘
表	手錶
馬錶	跑錶	停錶
懷錶	掛表
錶針	指針
錶盤	表面
漏刻	漏壺	漏	銅壺滴漏
化妝品	脂粉
生髮油	頭油	髮蠟	髮乳
唇膏	口紅
撲粉	香粉	爽身粉	粉
香水	花露水
飾物	裝飾品	裝飾	什件兒	飾	飾品
流蘇	穗子	穗	旒
髮夾	髮卡
首飾	頭面	妝
戒指	戒	指環	手記	鎦子	鑽戒
耳環	耳墜子	鉗子	珥	耳墜	耳針
項鍊	項練	項圈
鐲子	手鐲	鐲	釧	玉鐲
玉簪	發簪	簪子	珈	簪纓
繡品	刺繡	平金
傘	陽傘	雨傘	晴雨傘
蓋	華蓋
陽傘	旱傘	遮陽傘
扇子	扇
葵扇	芭蕉扇
團扇	紈扇
電扇	風扇	電風扇
暖壺	湯壺
烘籃	烘籠	手爐
玩具	玩意兒	玩物	玩藝
彈子	玻璃球
風箏	紙鳶	鷂子	斷線風箏
玩偶	託偶	土偶	偶人	木偶
撥浪鼓	波浪鼓
鈴	鈴鐺	鑾	鐸	響鈴	鈴兒
梆子	梆	柝
哨子	哨	鼻兒
醒木	驚堂木
煙火	焰火	煙花
爆竹	炮仗
雙響	二踢腳
鞭炮	鞭
棺材	棺木	木	材	棺	櫬	棺槨
靈柩	靈櫬	靈	柩
壽材	壽木
骨灰盒	骨灰箱
冥器	殉葬品
靈牌	靈位	牌位	神位
俑	偶人	兵馬俑
銀錠	錫箔
衣料	料子	布料	面料
毛料	料子
零頭	布頭
布	布匹	棉布	棉織品	布帛
粗布	毛布	土布
斜紋布	斜紋
羽緞	羽毛緞
卡其	哢嘰
花布	印花布
夏布	麻布	緦
燈芯絨	條絨	燈心絨
絲綢	綢緞	綢子	緞子	羅	綢	緞	縐	綈	錦	紡	帛	絲織品	綾欏綢緞
紡綢	小紡
紈	縑
練	縞
柞絲綢	繭綢
香雲紗	莨綢	拷紗	拷綢
春綢	線春
彩綢	彩
毛葛	葛
呢絨	呢子	呢	毛呢	毛織品
直貢呢	禮服呢
駝絨	駱駝絨
針織	針織物
衣服	衣物	衣著	衣裳	衣衫	服	裝	衣	服裝	服飾	衣裝	行頭	行裝
大衣	大氅	皮猴兒	棉猴兒
披風	斗篷
披肩	帔
長衫	大褂	長袍	袍	袍子	袷袢
罩衫	罩袍	外罩	罩衣
內衣	小衣裳	小褂
中裝	中服	成衣
西裝	西服	洋裝	洋服
盛服	盛裝
禮服	大禮服	燕尾服
朝服	蟒袍
便裝	便服	便衣
外衣	外套
夏裝	夏衣
冬裝	冬衣	寒衣	棉衣
皮衣	裘
童裝	小衣裳
兜肚	兜兜
睡衣	睡袍
軍服	軍裝	戎裝	甲胄	盔甲	鐵甲	披掛	老虎皮	軍衣	裝甲
法衣	袈裟	百衲衣	衲	道袍	直裰
戲裝	戲衣
孝服	重孝	喪服	素服	縞素	孝
鶉衣	百衲衣
上裝	上衣	上身	褂子	短裝	短打	襖	緊身兒	衫	褂	小褂兒
背心	馬甲	坎肩
馬褂	單褂
襯衣	襯衫
汗衫	汗褂
絨衣	衛生衣
褲子	褲	下身	小衣
襯褲	褲衩
絨褲	衛生褲
裙子	裙	裳	裙裝
連衣裙	布拉吉	套裙
領子	領	領口	衣領
褲腰	腰	腰身
衣袋	口袋	衣兜	兜	荷包	囊中	私囊
袖子	衣袖	袖管	袖筒	袖	袂
衣襟	衽
大襟	裾
後襟	後身
前襟	前身
帽	帽子	冠	笠	盔	冕	冠冕	帽盔	頭盔
斗笠	箬帽	斗篷	草帽	氈笠
小帽	瓜皮帽
紗帽	烏紗帽	烏紗
皇冠	王冠
鞋	鞋子	屣	履	舄	屐	屨
拖鞋	趿拉兒
木屐	趿拉板兒
皮鞋	革履
繡花鞋	繡鞋
雨鞋	釘鞋	套鞋	膠鞋
跑鞋	釘鞋	球鞋	運動鞋
靴	靴子
頭巾	網巾	幘
圍巾	圍脖兒	圍脖
襪子	襪
手套	拳套
糧食	食糧	糧	菽粟
乾糧	餱糧	糗
粗糧	糙糧
米	大米	白米	稻米	精白米
秈米	機米
碎米	粞
江米	糯米
糙米	糲
秫米	高粱米
米粒	糝	飯粒
米粉	米麵
麵粉	白麵	面
玉米麵	棒子麵
麩子	麩皮
飼料	草料	秣	食	料	飼草
糧草	糧秣
魚餌	釣餌	餌	餌料
魚蟲	金魚蟲	水蚤
食物	食品	食
飯食	飯菜
熟食	煙火食	煙火
宵夜	飧
主食	主食品
副食	副食品
零食	零嘴
肉品	肉食品	肉製品
飯	米飯	白飯	白玉	白米飯
蓋飯	蓋澆飯
份兒飯	客飯	份飯
粥	稀飯	米湯	糜
羹	肉湯
鍋巴	鍋貼
麵條	面
湯麵	麵湯
抻麵	拉麵
削麵	刀削麵
卷子	卷	花卷
饅頭	包子	饃	饃饃	餑餑
餅子	餑餑
雜糧	粗糧
窩頭	窩窩頭
油茶	油茶麵兒
菜肴	菜	小菜	菜蔬	下飯
酒食	酒飯	酒菜
美食	美味	佳餚	珍饈	美食佳餚	佳餚珍饈
山珍海味	水陸	山珍	生猛海鮮
糟糠	粗茶淡飯
冷盤	拼盤	小吃
菜碼兒	澆頭
葷菜	葷腥	油膩	肴	大魚
全家福	一品鍋
魚鮮	海鮮
肉排	排骨
肉末	肉鬆	肉絲
肉丸	獅子頭
脯	臘肉	鹹肉
烤肉	炙
豬蹄	蹄子	爪尖兒
粉蒸肉	米粉肉
白肉	肥肉
雜碎	下水	上水
肥腸	圈子	腸兒
蝦米	海米	蝦皮
干貝	江珧柱
魚翅	翅	翅子
鯗	鯗魚
鹹魚	鮑魚
松花	松花蛋	皮蛋	變蛋
肉片	臠	肉類
生肉	鮮肉
素菜	素	齋	素餐
千張	豆腐皮
豆腐乾	香乾
豆腐乳	醬豆腐	腐乳	豆乳
豆腐皮	豆腐衣
豆芽兒	豆芽菜	豆芽
粉條	粉
粉絲	粉
調味品	作料	調料	佐料
八角	大料	茴香
味精	味素
澱粉	小粉
胡椒	胡椒麵
薑	生薑
花椒	椒
動物澱粉	糖原
油	食油
素油	清油
豬油	大油	葷油
菜油	菜子油	清油
茶油	清油
花生油	生油
芝麻油	麻油	香油
板油	脂油
鹽	食鹽	氯化鈉	鹽巴	積雪	鹺	鹽粒	鹽類
岩鹽	礦鹽
醬	醢
芝麻醬	麻醬
果子醬	果醬
醋	醯	酢	陳醋	苦酒	白醋
糖	食糖	糖類	糖料
點心	點	茶食
甜食	甜品	甜點	糖食
糕點	餑餑
糕餅	餌	果餌
餅	餅餌
烙餅	餅子
燒餅	大餅	火燒
油條	油炸鬼
餃子	餃
湯圓	湯糰	元宵	圓子
團子	團	飯團
粽子	粽
餛飩	抄手
江米酒	酒釀	醪糟
糖果	糖	糖塊
飴糖	飴	麥芽糖	糖飴
糖稀	餳
糖葫蘆	冰糖葫蘆
蜜餞	果脯	脯	桃脯
果料兒	果仁兒	果料
餡料兒	心子	餡
酵子	鮮酵母
髮粉	起子
酒麴	酒母	曲	酒藥
麵肥	發麵
飲料	飲	飲品
豆漿	豆乳	豆汁	灝
可哥	可哥茶
咖啡	咖啡茶	雀巢咖啡
冰棍兒	冰糕	冰棒	冰棒	雪條	冰棒
冰淇淋	霜淇淋
冰糕	雪糕
茶	茶葉	茗
磚茶	茶磚
花茶	香片
茶晶	茶鹵
酒	釀	酒漿	杯中物
美酒	醇酒	醇醪	醑	瓊漿	玉液瓊漿	名酒	佳釀	瓊漿玉露
黃酒	紹興酒	紹酒	老酒	陳酒	花雕
白酒	燒酒	白乾兒
甜酒	醴
清酒	水酒	酤	酒水
乳酪	酪
酥油	油
藥品	藥物	藥	藥味	藥石	藥料
中藥	國藥	中醫藥	中藥材
丸	丸藥	藥丸	丸劑
散	藥粉	藥面	散劑
膏	膏藥	藥膏
湯藥	湯	湯劑	藥水	藥液	口服液
藥引子	引子	藥餌	藥撚子　
飲子	飲
針劑	針
試劑	試藥
沖劑	浸劑
麻醉劑	蒙藥	麻藥
栓劑	坐藥	藥栓
製劑	藥劑	劑
酊劑	酊
酏劑	酏
醑劑	醑
靈丹	妙藥	靈丹妙藥	特效藥	聖藥	苦口良藥
青黴素	地黴素
磺胺	氨苯磺胺
牛痘苗	痘苗
結核菌素	結素
安眠藥	催眠藥
紅汞	汞溴紅	紅藥水
龍膽紫	甲紫	紫藥水
麝香	麝
奎寧	金雞納霜
阿膠	驢皮膠
蜂王漿	王漿	蜂皇精	蜂乳	蜂王精	花露	花蜜	槐花蜜
蜂蜜	蜜	蜜糖
樟腦丸	衛生丸
滴滴涕	敵百蟲	敵敵畏	敵殺死	六六六
避孕片	避孕藥
咖啡因	茶精	茶素
造影劑	顯影液
維生素	維他命
維生素	煙酸
補品	滋補品	滋養品	營養	營養片	營養品	營養素	蜜丸子	補藥
保鮮劑	防腐劑
去污劑	清潔劑
毒品	毒物	毒藥	毒	毒餌
毒酒	鴆毒	鴆	鴆酒
海洛因	白面兒	白粉
鼠藥	耗子藥
鴉片	阿片	大煙	煙土
砒霜	白砒	紅砒	信石	紅礬
煙	煙草
香煙	紙煙	煙捲兒	煙	煙捲
雪茄	捲煙	呂宋煙
煙斗絲	斗煙絲
煙絲	煙
煙頭	煙蒂	煙屁股
陽曆	太陽曆	西曆	太陽年
陰曆	太陰曆	夏曆	舊曆	農曆
伊斯蘭教曆	回曆
西元	紀元
時代	年代	世代	年月	紀元	世
古代	古	先	上古	太古	洪荒	遠古	史前	古時	邃	天元
近代	近現代
現代	當代	現世	今世	現當代	現時代
盛世	治世
亂世	濁世
新篇章	新紀元
朝代	王朝	朝	代	時
歷朝歷代	歷代
年代	年歲	年間	年份
時期	時代	時日	一時	一代	一世	時	期	秋
年月	日月
時間	時刻	時日	工夫	日子	光陰	時光	韶光	韶華	年華	年光	流光	流年	年月	歲月	歲時	日	時	辰	時空
日期	日子
一向	陣子	晌
時候	時節	時分	時刻	天時	天道	早晚	當兒	時光	辰光	時	際	上	下	時段
時機	天時	機會	機遇	機	會	時	隙	空子	火候	機時
關頭	關鍵	轉機	轉捩點	轉捩點	關口	契機	節骨眼	當口兒	關	緊要關頭	之際
平時	平常	平日	素日	素常	平素	平生
暇時	閒暇	餘暇	閒空	空閒	閒工夫	空	暇	閑	隙	間	餘	空隙	間隙	空當兒	茶餘飯後	茶餘酒後	空餘
期限	限期	期	定期	時限	年限	為期
期間	間	中	內	裡	次	中間	之間	裡邊	裡頭	裡面	以內	之內
始終	前後	自始至終
初期	前期	早期	初	頭	首	最初
年初	年頭	歲首	開春	新春	新年	新歲
月初	朔望
中期	中葉	中	半
正月十五	月中
末期	後期	晚期	末葉	末世	末代	末年	末梢	末了	末尾	終了	末	底	終	闌	杪	季	晚	深	暮	期終	期末	末日
年終	年底	年末	歲末	歲暮	歲尾	殘年	年尾	年根兒	年關
月終	月底	月末	月杪
現在	現時	如今	當今	現今	而今	於今	今朝	今	茲	本	現	現下	今天	今日	現行	現如今	今昔	現在時
目前	眼前	當前	眼下	眼底下	目下	當下	腳下	時下	即	時	此時此刻	手上	現階段
過去	從前	已往	以往	往常	往昔	平昔	昔日	往日	舊日	舊時	往年	早年	昔年	疇昔	昔	往	往時	陳年	既往
自古	古來	終古	亙古	曠古	古往今來	自古以來	以來
從小	自小	自幼	生來	有生以來
至今	迄今	於今	至此	由來	時至今日	迄今為止	從那之後
以前	先前	先	早先	原先	在先	此前
事先	之前	前	事先	前面	前頭	先頭	頭裡	事前	有言在先
前夕	前夜	昨晚	昨夜
近來	近日	新近	最近	日前	近年	前不久	不久前	近年來	近些年	多年來	以來	連年來	近期	近世
將來	未來	明日	明天	明朝	前	來日	他日	明晚	明晨
即日	不日	日內	在即
改日	改天	來日	他日	下回
以後	之後	後	往後	而後	爾後	日後	今後	此後	從此以後	嗣後	隨後	過後	後來	後頭	下	事後	其後	然後	從此	自此
一會兒	不一會兒	不久以後
身後	百年之後
隔日	間日
一生	一世	終身	終生	畢生	平生	一輩子	生平	終天	百年	一生一世	輩子	長生
今生	今世	現世	今生今世
半生	半世	半輩子	大半生
前半輩子	前半生
後半輩子	後半生
年齡	年紀	年歲	歲數	春秋	年華	年事	年	歲	庚	齡	齒
不惑	不惑之年
半百	知天命之年
高齡	遐齡	高夀	大壽	年過花甲	年近花甲	耄耋高齡	年過半百	年逾花甲	耆
牙口	口
低齡	幼齡
童年	幼年	童稚	小兒	孩提	繈褓	垂髫	髫齡	髫年	總角	兒時	幼時	小時候
少年	妙齡	豆蔻年華
青年	青春	韶光	韶華	華年	妙齡	花季	黃金時代
壯年	中年	盛年
晚年	老年	老境	暮年	歲暮	殘年	殘生	餘年	餘生	夕陽	耄耋之年	有生之年	風燭殘年	桑榆暮景	老齡	天年	垂暮之年	中老年	龍鍾	年長
年	年份	年度	茲	載	歲	春	夏	秋	東	稔	春秋	寒暑	陰曆年
十年	旬	秩
百年	世紀
今年	當年	本年	現年	當年度
明年	來年	翌年	過年	新年	明
去年	去歲	上年	頭年	舊年	舊歲
每年	年年	歷年	歲歲年年	每年度	年年歲歲
四季	四時	一年四季
春	春季	春天	春令	青春	陽春	春日	去冬今春
初春	開春	新春	早春
暮春	季春
夏	夏季	夏天	夏令	夏日	暑天	三夏	伏季	夏令時
初夏	夏初
炎夏	炎暑	伏暑	大暑	盛暑	酷暑	隆暑	三伏	烈暑	三伏天	盛夏
秋	秋季	秋天	秋令	三秋	金秋
深秋	晚秋	暮秋
冬	冬季	冬天	冬令
嚴冬	隆冬	寒冬	深冬	寒冬臘月	臘	十冬臘月
季節	季	時令	令	時節	時	噴
黃梅	黃梅季	黴天
伏天	三伏
中伏	二伏
末伏	三伏
數九	九	數九寒冬	數九寒天
月	月份	月度
正月	新月	元月	歲首	一月	元月份
二月	仲春
三月	季春	暮春
四月	四月份
五月	仲夏	五月份
八月	仲秋
九月	暮秋
十月	小陽春	陽春	小春
十一月	仲冬
十二月	臘月
小月	小建	小盡
星期	周	禮拜
星期一	週一	禮拜一
星期二	週二	禮拜二
星期三	週三	禮拜三
星期四	週四	禮拜四
星期五	週五	禮拜五
星期六	週六	禮拜六
星期日	星期天	星期	禮拜天	禮拜日	禮拜	周日	週末	小禮拜
日	天
當日	當天	即日	同一天
今日	今天	今兒	今兒個	今朝	今
明日	明天	明兒	明朝	明	次日	翌日
昨日	昨天	昨	昨兒	昨兒個
前日	前天	前一天	頭天
初一	朔日	朔	正月初一
月半	望日	望
月底	晦
每日	每天
雙日	單日
半日	全天
節氣	節
夏至	長至
冬至	長至
節日	節	紀念日	節假日
佳節	節令
婦女節	三八節	三八婦女節
勞動節	五一節
八一建軍節	八一	建軍節
除夕	年夜	大年夜	除夕夜
年初一	大年初一	元旦	正旦	三元
春節	年節	新年	新春	新春佳節
元宵節	上元節	燈節
端午節	端午	端陽	五月節
中秋節	八月節	團圓節	中秋
重陽節	重陽
假日	假期	休假	假
生日	誕辰	生辰	壽辰	壽誕	華誕	大慶	八字
忌日	忌辰
婚期	佳期	好日子
吉日	好日子	黃道吉日
黎明	淩晨	拂曉	破曉	向明	曙	昕	晨夕
早晨	早上	早	朝	晨	早起	天光	早間	晁
清晨	一清早	大清早	清早	一早	大早	一大早
朝朝暮暮	花朝月夕
上午	午前	前半天	上半晌	前半晌
中午	正午	午	晌午	日中	午間
下午	午後	下半天	後半天	下半晌	後晌
白天	白晝	日間	晝	大白天	大天白日	青天白日	光天化日	白日	晝間	大清白日
傍晚	黃昏	垂暮	薄暮	擦黑兒	暮	夕	遲暮
晚上	夜晚	晚間	夜裡	夜間	晚	夜	夜幕	宵	夕
當晚	當夜	連夜
夜間	夜裡	星夜	夜	夕
半夜	夜半	三更	子夜	午夜	中宵	夜分
深夜	漏夜	深更半夜	黑更半夜	半夜三更	三更半夜
前半夜	上半夜
後半夜	下半夜
晝夜	日夜	白天黑夜
早晚	晨昏	朝暮	朝夕	旦夕
小時	鐘點	鐘頭	時
時	點鐘
學時	課時
時辰	時	辰
這時	這時候	這	此時	此刻	這兒	這會兒
那時	那時候	當時	當初	當下	當場	那兒	那會兒	那陣子	其時	彼時	當年
幾時	何時	多會兒	哪會兒	哪一天	何日
方向	方位	方面	方	向
同方向	一順兒
位置	部位	地位	位	窩
座位	位子	席位	席	座	坐位	坐席	座席
上座	上位	首席	首座
下位	末座
鋪位	床位
東南西北	四方
東	東方	東邊	左	正東	東面	東頭
南	南方	南邊	正南	陽	南部	南緣	陽面
西	西方	西邊	正西	右	西頭	西部	西面
北	北方	北邊	朔	正北	陰	北部	北緣	北頭
上	上面	上邊	上頭	上端	頂端	頭	上方
以上	之上	如上	上述
下	下麵	下邊	下頭	底下	底	腳	下部
以下	以次	之下	偏下
左	左面	左邊	左首	左手	上手	上首	裡手	左側	左方
右	右面	右邊	右首	右手	下手	下首	外手	右方	右側
前	前面	前邊	前頭	前方	頭裡	先頭	眼前	面前
後	後面	後邊	後頭	背後	末端	末尾	尾	後身	後部
中	中間	中心	中央	正中	當中	居中	正當中	當腰	當心	當間兒	當道	半	間	心	之中	中部	中點	中段
內	中	裡	裡面	裡邊	裡頭	以內	之內
深處	奧
國內	海內	境內
外	外面	外邊	外頭	外界	以外	之外	週邊	外側	外圈	外場
室外	露天	窗外	戶外
野外	郊外
國外	海外	域外
內外	裡外
旁邊	邊緣	邊沿	邊際	邊	旁	畔	沿	濱	滸	幹	際	兩旁	一旁	邊上	一側	外緣
耳畔	耳際
附近	就近	鄰近	近處	一帶	內外	左右	左近	前後	近水樓臺	就地	近旁	跟前	不遠處
手頭	手邊	手下
周圍	四周	四圍	周緣	方圓	四鄰	四下裡	郊	四郊	四下	四周圍	四旁
對面	對門
天	天空	空	宵	圓	天上	皇上	天宇	玉宇	上蒼	蒼天	天幕	天穹	蒼穹	穹蒼	太虛	老天	穹幕	穹	中天	昊
高空	太空	雲霄	九霄	九天	雲天	雲漢	霄漢	九重霄	滿天	重霄
晴空	青天	碧空	藍天
空中	空間	上空	長空	半空	半空中
天際	天邊	天極
地	大地	壤	土地	地皮	方	大方
地方	地域	地區	地面	地段	地帶	處	所在	域
市區	城區	城廂
故地	舊地
空地	隙地
立錐之地	彈丸之地
源	源頭	發源地	策源地	發祥地	搖籃
北國	北疆
地點	地址	地方
匯合處	交界處	交匯處
農技站	農技推廣站
灌溉站	排灌站
推廣站	宣傳站
飛機場	機場	航空站	航站
空白點	空白處
宅基地	居所	住地	居住地
到處	各處	各地	處處	所在	隨處	四方	八方	四處	四下裡	萬方	四海	五湖四海	五洲四海	大街小巷	街頭巷尾	四面八方	滿處	無處	天南地北	無所不至	四野	遍野	無所不在
遍地	匝地
山區	山國	山窩窩	山窩
水鄉	澤國
上游	上流
中游	中流
下游	下流
遠方	遠處	天邊	海外	天涯	邊塞	塞外	異域	地角	角落	角	山南海北	天	天涯地角	天涯海角	海角天涯	地角天涯
邊遠	邊地	邊陲
僻壤	荒漠	鄉曲	陰山背後	窮鄉僻壤
內地	腹地
前方	前線	前敵	前沿	火線	戰線
陣地	防區	戰區
後方	大後方	總後方	後
駐地	營地	軍事基地	營	營寨	寨	大本營	本部	基地
戰場	疆場	沙場	戰地
領土	疆土	疆域	領域	土地	幅員	國土	河山	山河	金甌	版圖	寸土	錦繡河山	海疆
孤島	半壁江山
屬地	埰地	領地	封地
失地	敵佔區	淪陷區
邊疆	邊界	國境	國門	邊陲	邊防	邊境	邊疆區	邊區
界線	界	垠	際	分界	限界	界限	疆界	境界	邊界	地界	邊際	疆	畛域	鄂
本地	本土	當地	該地	地方	地面	地頭
外地	外邊	他鄉	外鄉	異鄉	異地
家鄉	故鄉	本鄉	鄉	裡	本土	故園	家門	鄉里	鄉土	鄰里	梓裡	桑梓	本鄉本土	故里	故土	出生地	母土	誕生地	閭裡	熱土
勝地	佳境	勝景	妙境	畫境	仙境	名勝	名山大川	蓬萊仙境	仙山瓊閣
樂園	樂土	福地	魚米之鄉	天府之國	米糧川	世外桃源	天府
樹蔭	綠蔭	蔭	樹涼兒	濃蔭
荒地	荒	荒郊	荒丘	野地
墳地	墓地	墳塋	塋	墳山	亂墳崗	墓園
要地	要衝	要害	要隘	要塞	重地	中心	重鎮	鎖鑰	門戶	咽喉	險要	必爭之地
險地	險	險隘	天險	山險	險工	絕地	危險區	鬼門關	龍潭	虎口	虎穴	龍潭虎穴	刀山火海	深溝高壘	懸崖峭壁	火海刀山
關口	關	邊關	雄關	關隘
卡子	卡	關卡
廉潔關	廉政關
驗收關	檢驗關
設卡	立卡
渡口	渡頭	渡	津
路口	街口	街頭
十字路口	十字街頭
岔口	三岔路口
通道口	入口	進口
缺口	破口	裂口	豁口	豁子	斷口
決口	決	口子	潰決
洞	孔	竇	漏洞	孔洞	孔穴	穴	窟窿	窟窿眼兒	鼻兒
山洞	岩洞	洞穴	隧洞
地洞	地道	坑道	坑	地穴	地窟
卯眼	鑿	榫眼
縫	罅	罅隙	縫隙	孔隙	裂隙	裂縫	縫子	夾縫	中縫	縫縫	騎縫
空隙	空兒	空子	當兒	空當
坑	坑穴	埂
點	心
線	線條	線段
垂線	垂直線
圓心角	中心角
多面角	立體角
傾角	傾斜角
磁傾角	傾角	磁偏角
面	平面
剖面	切面	斷面	截面
橫剖面	橫切面	橫斷面
縱剖面	縱切面	縱斷面
水平面	水準	海平面
立方體	正方體	立方
球體	球	圓球
角錐體	棱錐
角柱體	棱柱體
幾何體	立體
拐角	拐彎	轉角	拐	曲	套	彎	隈
角落	犄角	旮旯兒	角	隅	陬	旮旯
城市	市	城	都	邑	垣	都會	都市	城邑	城池	通都大邑	地市
碼頭	埠	船埠	埠頭	浮船塢
大都市	大都會	大城市
我市	本市
危城	舊城	堅城	古城	古都	故城
集鎮	鎮	鎮子	市鎮	鄉鎮	村鎮	城鎮
鄉村	農村	鄉間	鄉下	鄉	果鄉	山鄉	村野	村村落落	村村寨寨	小村	小村子	村屯	鄉野
村莊	村	莊	村子	村落	聚落	莊子	屯子	農莊	山村
荒村	三家村
寨子	寨	村寨	邊寨	大寨	山寨
車站	站
港口	口岸	港	海港	海口	港灣	停泊地
道路	路途	路徑	路	徑	程	道	途	蹊	衢	馗	通衢
陸路	旱路
水路	水道	海路	水程
大路	大道	通道	通途	坦途	通路	康莊大道	陽關道
小路	便道	小徑	蹊徑	羊腸小徑	羊道
山路	山道	山徑
彎路	彎道	曲徑	之字路
岔路	岔道	岔子	歧路	三岔路
遠路	遠道
近路	近道	抄道	捷徑
要道	孔道	要路	要衝	咽喉
隘路	畏途
中途	半途	半道	半路	路上	途中	旅途
高架道路	高架路
盤山路	盤山道
主幹路	主幹道
路線	路	線	線路	路經
軌道	軌跡
航路	航線	航道	航程
場所	處所	場地	場子	場院	場道	場合
現場	當場	實地
住所	寓所	寓	居	舍	邸	家	公館	下處	安身之地
哨所	崗哨	觀察哨	崗
試場	考場	試院	闈
市場	商場	市井	市
集市	市集	圩場	廟會	集	街	場	廟	會	擺	墟	集貿
刑場	法場
屠場	屠宰場
會館	會所
容身之地	宿處	寓舍
英雄無用武之地	無用武之地
妓院	煙花巷	窯子	北裡	花街柳巷	秦樓楚館
巢穴	老巢	老營	窟	窩	窩巢
匪巢	匪窟	匪穴	強盜窩	賊窩
賭窟	賭場	賭窩
這裡	這邊	此地	此間	此處	此
那裡	那邊
哪裡	何處	哪兒	何方	何地
事情	事	務	政	事宜	事務	事體	碴兒	事兒
事項	須知
兩回事	兩碼事
事實	實事	實際	現實	史實
國事	國務	國事	國家大事
政事	政務
外事	外務	洋務
要事	大事	盛事
公事	公務	公幹	公	差	差事
急事	急	警	緩急
危險	奇險
難事	難題	苦事
時事	新聞	時務
趣事	佳話
好事	佳話	美談	好人好事	幸事
樂事	快事	賞心樂事
喜事	好事	喜	美事	雅事
婚事	親事	婚姻	親	婚	喜事	大喜事	天作之合	終身大事
喪事	白事	後事	橫事
紅白喜事	紅白事
佛事	法事	功德	香火	道場	水陸
憾事	恨事	憾	遺恨
世事	塵世	塵事
逸事	軼事	佚事
奇事	怪事	咄咄怪事	蹊蹺	蹺蹊	特事
遺事	事蹟	紀事	史事
風流韻事	韻事	雅事
瑣事	瑣屑	瑣碎	小事	閒事	小節	末節	細節	枝節	枝葉	細故	細枝末節	麻煩事	雜事
家事	家務	家務事	家政
秘事	秘密	奧秘	隱秘	隱私	陰私
機密	事機	天機	軍機	機關
虧心事	缺德事
壞事	勾當	劣跡	壞人壞事
醜	醜事	醜聞	穢聞
鱗爪	片斷	一鱗半爪
蠢事	傻事
非公務	私事
事事	萬事	諸事
新鮮事	新人新事
風險	高風險
事件	事變	風波	波	軒然大波
慘案	血案
事故	事	故	事端	岔子	問題
麻煩	枝節	疙瘩	糾紛
意外	萬一	不虞	長短	好歹	差錯	閃失	三長兩短
變故	變	情況	事變	變動	變化	風吹草動	晴天霹靂	平地風波
波折	曲折	一波三折	反復	幾經周折	歷經滄桑	飽經滄桑
滄海桑田	滄桑	翻天覆地
動亂	變亂	亂	騷動	騷擾	擾動
十年動亂	十年浩劫
風潮	浪潮	潮	大潮
狂瀾	狂飆	風暴	風浪	大風大浪	狂風惡浪	驚濤駭浪	暴風驟雨	狂風暴雨	雷暴	風口浪尖	驚濤激越	風雲突變	冰風暴
渦流	水渦	旋渦	漩流
群眾運動	人民戰爭
工人運動	工運	工潮
狂潮	熱潮
事例	例	例子	例證
比方	譬喻	比喻	譬	舉例	舉例來說
先例	前例	成例	成規	舊案	判例	先河
慣例	向例	常例	定例	常規	老	規矩	老辦法	老框框	老規矩	老例
案件	案子	案	公案
血案	命案	兇殺案	殺人案	謀殺案
疑案	懸案	無頭案
冤案	冤獄	錯案	假案	冤假錯案
投訴案	訴訟案
本案	該案	此案
大要案	大案要案
疑問	問號	問題	疑案	疑團	疑難	疑竇	疑點	疑雲	疑義	謎	悶葫蘆	狐疑	疑陣
嫌疑	嫌	瓜田李下
過程	進程	經過	歷程	長河
始末	本末	首尾	起訖	原委	源流	事由	前後	前前後後	前因後果	來龍去脈	全過程
內中	其中	此中	中間	其間	裡頭	裡邊	裡面	內部	裡	內	中	間	個中	之中
開端	肇端	發端	開始	肇始	起始	起首	起頭	起初	開頭	劈頭	苗子	苗頭	開場	序曲	序幕	前奏	先聲	胚胎	伊始	原初	開局
破天荒	開天闢地	第一遭
新春伊始	新年伊始
末尾	末了	末	末梢	結尾	煞尾	尾聲	尾子	末後	最後	最終	終極	說到底	末段
結局	終局	了局	結幕	終結	歸結	收場	下場	結果	歸根結底
往事	舊事	成事	舊聞	前塵	歷史	陳跡	史跡	老黃曆	明日黃花	過眼雲煙
經歷	閱歷	資歷	閱世
歷史	史
豔史	浪漫史	羅曼史
病歷	病案	病史
古代史	古史
科學史	科技史
建築史	建設史
政策史	謀略史
戰史	軍史	戰爭史
醫史	醫學史
前途	前景	前程	鵬程	未來	奔頭兒
出息	爭氣
遭遇	遭際	際遇	景遇	境遇	身世
風浪	風霜	風雨	大風大浪
宦途	仕途
冷遇	冷眼	冷板凳
慘境	淒風苦雨
冷暖	炎涼	甜酸苦辣	酸甜苦辣
順境	佳境
逆境	下坡路	下坡
命運	氣運	氣數	運	運氣	命	天命	數	天數	大數	造化	流年	天意	天機	天時
紅運	幸運	天幸	吉人天相
苦命	薄命
揹運	厄運	災星
時運	時氣
同呼吸共命運	共命運
福氣	福分	造化	幸福	福	祜	祉	祚	福祉	鴻福	洪福
災禍	災難	災殃	難	厄	劫	劫數	不幸	三災八難	天災人禍
災害	災患	災	災荒	成災
禍事	禍亂	亂子	婁子	禍害	禍患	禍殃	禍祟	禍	害	殃	患	巨禍	大禍
浩劫	滅頂之災	洪水猛獸	天災人禍	劫難	萬劫不復
橫禍	橫事	飛災	飛來橫禍	無妄之災
禍根	禍胎	禍端
兵亂	兵燹	戰亂	戰禍
匪禍	匪患
外禍	外患	敵害
遺禍	後患
天災	災荒	自然災害	荒災
澇災	澇害	內澇
水災	水患	洪災	水害
火災	火警
旱災	大旱	亢旱
饑荒	饑	荒	饑饉	糧荒
海難	海事
地震	地動	震	震害
蟲災	蟲害
風災	風害
禍福	吉凶	休戚	旦夕禍福	安危禍福
苦痛	痛苦	苦楚	痛楚	酸楚	苦處	痛處	苦頭	苦難	苦水	苦	切膚之痛
疾苦	困苦	痛癢	瘼
磨難	折磨	千磨百折	千難萬險
難題	難點	難處	難關	困難	難	艱
挫折	失敗	失利
冤屈	冤枉	屈	冤	枉
沉冤	不白之冤	覆盆之冤
恩惠	恩典	恩德	恩澤	恩情	恩遇	雨露	人情	好處	春暉	恩	惠	德
大德	大恩大德	洪恩	澤及後人
甜頭	小恩小惠
活命之恩	救命之恩	再生之恩
冤仇	冤	仇	仇恨	仇怨	睚眥
切骨之仇	深仇大恨	血海深仇	血仇	苦大仇深	血債
世仇	舊惡	宿仇
恩怨	恩仇	恩恩怨怨
分歧	齟齬	矛盾
嫌隙	隙	嫌	裂痕	芥蒂	隔閡	隔膜	疙瘩	碴兒	不和	釁	夙嫌	糾紛	糾葛	爭端	失和
榮譽	榮耀	榮幸	光榮	光彩	光	榮	驕傲	桂冠	殊榮
恥辱	羞辱	恥	辱	垢	侮辱	污辱	屈辱	奇恥大辱
污點	穢跡
榮辱	盛衰榮辱
成就	造就	成	大成	成績	勞績	成法	實績
收穫	果實	成果	碩果	結晶	名堂	一得之功	勝利果實	戰果	勝果
建樹	卓有建樹
新績	紀錄
功勞	功	貢獻	功績	勞績	功德	赫赫功績	績	佳績
一等功	頭等功	頭功
勳勞	勳績	勳業	功勳	勳
業績	功績	事功	功業
殊勳	奇勳
戰功	武功	戰績	汗馬功勞	軍功	勝績
偉績	偉業	豐功偉績	奇功偉業
功在千秋	功在當代	豐功	大功	居功至偉	奇功
過失	過錯	疏失	失誤	失閃	閃失	毛病	罪過	非	過	錯	失	罪	咎	愆	眚	尤	瑕	疵	疵瑕
功過	功罪
是非	好壞	長短	黑白	曲直	是非曲直	是是非非	對錯	貶褒	敵友
差錯	過錯	錯誤	錯處	偏差	偏向	不是	謬誤	舛誤	訛誤	不對	訛謬	紕繆	錯	差	病	誤	訛	謬	魯魚亥豕	魯魚帝虎	大過	錯事
一差二錯	陰差陽錯	陰錯陽差	誤會	言差語錯
漏洞	漏子	破綻	紕漏	罅漏	馬腳	尾巴	狐狸尾巴
經驗	體驗	體會	心得	感受
教訓	鑒	殷鑒	鑒戒	覆轍	前車之鑒	以史為鑒	後車之鑒
借鑒	高抬貴手
印象	記憶
生命	性命	命	活命	人命	民命	身	生
生死	存亡	死活	陰陽	生死存亡	生老病死
壽命	壽	壽數	人壽
長命	長壽
殘生	餘生	劫後餘生	虎口餘生
生活	日子	光陰	光景	小日子
衣食	家常	寢食	衣食住行	家長里短	柴米油鹽
性生活	性行為	房事	雲雨	人道	歡
戎馬一生	戎馬生涯
身心	心身
生計	活計	生涯	生路	生
飲食	茶飯	膳食	膳	伙食	夥	飯食	口腹	餐飲
西餐	大菜
便飯	便酌	家常便飯	家常飯
酒飯	酌
早飯	早餐
中飯	午飯	午餐	午宴
晚飯	夜飯	晚餐	夜餐
包飯	包伙
消息	新聞	情報	訊	諜報	快訊	訊息	資訊
風聲	風	聲氣
佳音	福音	捷報	喜訊
傳聞	傳說	傳言	道聼塗説	小道消息	齊東野語	據說	據稱	空穴來風
死訊	死信	兇信	凶耗	噩耗
謠言	謠	謠傳	妄言	無稽之談
桃色新聞	緋聞
音信	音問	音訊	音息	消息	資訊	信	音	音塵
形勢	情勢	陣勢	局勢	局面	事機	事態	氣候	風雲	風色	風頭	風聲	勢派	態勢
現勢	現局	現狀
危局	危亡	敗局	死棋
全域	大局
時勢	時局	時務
平局	和局	平手	和棋
趨勢	趨向	傾向	動向	方向	勢頭	大勢	來勢	來頭	樣子	勢	大方向	主旋律	矛頭	可行性	取向	自由化	系列化
長勢	生勢	走勢	漲勢	增勢	升勢
頹勢	下坡路	低谷
潮流	浪頭	新款	保齡球熱	旅遊熱	投資熱	主潮	學習熱	辦水熱	房地產熱	散文熱	中國熱	開發熱	兼併熱	金融流	回歸熱
情況	情形	情狀	情事	狀	情	景	事態	狀況	狀態	景況	情景	場面	動靜	氣象	景象	圖景
真情	實情	實況	實際	事實	真相	謎底	實
內情	內幕	底細	底子	就裡	底	老底	根底	路數	虛實	背景	來歷	黑幕	底牌	內參	手底下
來頭	來路	來歷
詳情	端詳	詳
概況	概貌	大概	概觀	概略	大要	大略	崖略	輪廓	簡況	廓	外廓
境況	光景	境遇	手頭	手下	手邊
老境	晚景
家境	家道
病情	病況	病狀
市面	市場	商海
世面	場面	場景
實景	實處
境地	境域	情境	處境	地	境	步	地步	田地
困境	困厄	困處	苦境	泥坑	泥沼	窮途	末路	窮途末路	窘況	窘境
慘境	火坑	地獄	活地獄	苦海	淵海	煉獄	人間地獄
絕境	絕地	死地	深淵	萬丈深淵	無可挽回
險境	危境
境界	境域	化境	境地	境	程度	地步
意境	意象
佳境	夢境
夢鄉	夢境
環境	條件
氣氛	空氣	氛圍
現象	象
隕石雨	流星雨
跡象	徵象	徵候	形跡	行色	蛛絲馬跡	征
苗頭	苗子	意思
症狀	症候	病症	病象	病徵
預兆	先兆	兆頭	兆	朕	徵兆	前兆
吉兆	彩頭	祥瑞
凶兆	不祥之兆	惡兆
下落	著落	著	落子	歸著	垂落
蹤跡	蹤影	來蹤去跡
行蹤	行止	行跡
氣候	天候	氣象	天氣	天	天道
月令	節令	時令
季風氣候	小氣候
收成	收穫
年成	年光	年景	年
秋景	大秋
豐年	大年	熟年
平年	常年
荒年	歉年	歉歲	凶年
效用	功用	作用	功能	職能	效能	效	功效	功力	效力	力量	效果	成效	效驗	效應	效益	意義	法力	機能
用處	用途	用場	用
實效	證驗
特效	神效
副作用	負效應
反應	影響	反響	反射	感應	回饋
反作用	反動
名聲	名氣	聲名	名譽	聲譽	信譽	譽	名	聲	望	聲望	孚	聲價
名望	美譽
盛名	大名	美名	久負盛名	享有盛譽	小有名氣
眾望	人望	得人心
駡名	穢聞	惡名
虛名	浮名
聲威	威名	威望	威信
情面	人情	臉面	面子	臉皮	情	份	老臉	老面皮	老面子
面子	體面	面目	臉面	顏面	顏	臉	大面兒
勢力	勢
權勢	威武
惡勢力	魔爪	鐵蹄	腐惡	魔手
威風	威嚴	威勢	威	虎威	雄風	雄威
氣勢	勢	聲勢	氣魄	氣焰	勢焰
銳氣	銳
兇焰	兇氣	氣焰	敵焰
筆力	骨氣	風骨
事物	物	東西
物件	目標	靶子	靶
原因	因	故	緣故	原故	原委	原由	緣由	因由	來由	根由	由	由頭	由來	來頭	案由	青紅皂白
起因	緣起	導火線
情由	事由	情有可原	事出有因
病因	病源	病根
禍根	禍端	禍胎
結果	後果	果	結局	究竟	分曉	下文	產物	名堂
報應	報	因果	因果報應
惡果	苦果	蘭因絮果
根源	本源	淵源	起源	濫觴	根	根子	根苗	溯源	源自
源頭	源流	源
來源	源	泉源	源泉
水頭	水源
證據	佐證	證	信	憑	據	憑證	憑據	信物
明證	鐵證	確證	信據	實據	真憑實據	有根有據	有理有據
根據	依據	憑依	據
論證	論據	實證	立據
指針	南針	指南針
藉口	由頭	托詞	飾詞	口實	端	故	擋箭牌	託辭	遁詞	為由
理由	理	說辭	說頭兒
把柄	辮子	小辮子	榫頭
笑柄	笑談	笑料
話柄	口實	話把
典故	典	古典	掌故
出典	出處
目的	鵠的
宗旨	大旨	要旨	主旨	宏旨	弘旨	旨要	旨	宗
規律	法則	公例	公理	原理	常理	公設
定律	定理
經濟規律	經濟法則
自然規律	自然法則
邏輯	論理
道理	理路	事理	理	諦	所以然
大道理	大義	義理
真理	真諦	真知
正理	公理
歪理	邪說
正義	義	公道
天理	天道
教義	佛法	福音
玄機	玄	堂奧	禪機
情理	物理	大體
世情	人情	人情世故
死理	一面兒理
意義	義	意思	含義
定義	界說	概念
蘊意	意蘊
內蘊	內涵
頭緒	頭腦	端緒	端倪	眉目	線索	有眉目	初見端倪
條理	條	脈絡	條貫	板眼	倫次	系統	理路	眉目
思路	筆錄	構思
筆法	筆路	筆勢
立場	立腳點	立足點
角度	觀點	出發點	視角	著眼點	落腳點
就業觀	擇業觀
方法	法子	辦法	點子	主意	法門	章程	抓撓	道道兒	長法	方	法	術	智	轍	道	計	了局	措施	藝術	不二法門	方式	解數
常軌	常規	套套	框框
兵法	韜略	戰法	陣法
障眼法	遮眼法	掩眼法
反證法	歸謬法
花點子	花花點子
茶道	茶藝
灸	醃
集約經營	集約
訣竅	訣要	竅門	門檻	訣	秘訣	奧妙	三昧	門路	門道	門徑	技法	妙訣	要訣	妙法	良方	妙方
步驟	步調	步子	手續
關係	瓜葛	干涉	干係
群眾關係	人緣兒	人頭	人緣
友誼	情誼	交誼	交情	友情	情分	交	誼	義	雅
老交情	舊交	故交
深情	魚水情	魚水	血肉	骨肉	厚誼	深情厚意	親情	軍民魚水深情	手足之情	赤子情	親緣	直系
深交	至交	忘年交	莫逆之交	忘年之交	忘年情
私交	私情
邦交	國交
緣分	因緣	姻緣	緣	機緣	情緣
形狀	樣子	形態	形象	形制	造型	模樣	樣	形	狀	相	貌	象	狀貌
怪相	奇形怪狀	怪模怪樣
地形	地勢	形勢	勢	形	山勢	地貌
體形	身段	身材	體態	身條
條形	線形	帶狀
多邊形	多角形
三角形	三角	三邊形	三邊
菱形	口形	斜角
正多邊形	正多角形
幾何圖形	圖形	空間圖形
棱錐台	棱臺	臺式
圓錐台	圓臺	圓錐
圓圈	圈子	圈	周	匝	旋	環	圓形	環子	線圈
狀態	態
式樣	樣式	形式	式	花樣	款式	式子	試樣	樣款	款型
時樣	時式
排比	排偶
慘像	慘狀	痛苦狀
密閉式	封閉式
裝飾	裝璜
風景	景色	景致	景	色	山水	風光	光景	風月	風物	景物	景點	景觀	山色	青山綠水	山山水水	山光水色
春光	春色	韶光	韶華	蜃景	春暖花開
秋景	秋色
晚景	夜景	夜色	暮色	曙色	野景
舊景	舊貌
青山秀水	清山秀水
名勝古跡	勝跡
景象	現象	氣象	狀況	情景	光景	面貌	場面	容	觀	景	萬象	場景	此情此景	形貌
美景	良辰美景
幻境	幻影	春夢	幻夢	鏡花水月	幻景	幻像
村容村貌	村容
新氣象	新景觀	新貌
容貌	相貌	面貌	品貌	外貌	貌	容	相	面相	長相	形相	面容	姿容	容顏	眉眼	眉目	面目	模樣	樣子	形容	儀容	臉子	眉宇	眉睫	臉相	真容	原樣
美貌	紅顏	姿色	冶容	人才	花容玉貌	一表人材	媚顏	丰姿	蘭花指	濃眉大眼
姿勢	姿	姿態	架勢	架式	架子	功架	式子	相
雄姿	英姿	颯爽英姿
婀娜多姿	搖曳多姿	多彩多姿
步伐	步履	腳步	步子	步
退步	後步
方步	四方步	八字步
裝束	打扮	妝飾	扮相
豔妝	靚妝	濃妝豔抹
儀錶	儀容	儀態	儀觀	儀	人品
神情	神色	神氣	神采	表情	神	容	色
態度	姿態	神態	情態	千姿百態	態勢
言談	辭色
眼色	眼神
眼光	目光	眼神	眼波	秋波
臉色	面色	氣色	聲色	眉眼高低	眉高眼低
笑容	笑臉	笑顏	笑貌	笑影	一顰一笑
喜色	喜氣
愁容	愁雲	苦相	愁眉苦臉	憂容
怒容	怒色	怒氣	臉子
凶相	煞氣	殺氣
懼色	驚魂
醉意	酒意
美色	女色	媚骨
風度	風采	風儀	風姿	風範	儀態	標格	容止	氣概	氣度	氣宇	神宇	氣質	氣派	派頭	勢派	丰采	風韻	神韻	威儀
骨氣	風骨	俠骨	傲骨	鐵骨
豪氣	英氣	浩氣	氣慨
驕氣	傲氣
書卷氣	書生氣
性質	習性	特性	屬性	性能	性	機械性能	通性	總體性
趨光性	慕光性
準確性	準頭
可能性	可能
音質	音色	音品
生產經營性	營業性	業務性
緊縮性	伸縮性	壓縮性
預見性	前瞻性
廣泛性	普及性
不確定性	可變性
誘導性	誘惑性
革命性	探索性	開拓性	批判性
指導性	指令性
背日性	背光性
流動性	流通性
試驗性	實驗性	試錯性
緊迫性	迫切性
敏感性	過敏性
趨向性	趨利性
條理性	邏輯性
禮節性	象徵性
鼓動性	拉動性
可持續性	延續性
可操作性	操作性
自營性	自主性
永久性	永恆性
局部性	區域性
優點	長處	長	瑜	獨到之處	可取	亮點	長項	強點	助益
各有所長	學有所長
缺點	缺欠	欠缺	缺陷	短處	短	瑕疵	疵瑕	瑕玷	毛病	通病	癥結	瑕	疵	弱點	弱項	先天不足	疵點	敗筆	老毛病
益處	好處	利益	裨益	補益	便宜	益	補	裨	利	潤	實益	功利	進益	義利
現成飯	漁人之利	漁翁得利	大幅讓利
微利	蠅頭微利	小便宜	單利
功名利祿	名利
害處	壞處	弊端	弊病	流弊	弊	時弊
積弊	宿弊	無私有弊
切身利益	既得利益
利弊	利害	得失	成敗利鈍	優缺點
特徵	特點	特性	特色	風味	表徵	性狀
差別	別	區別	出入	差異	異樣	歧異	差距	距離	千差萬別	反差
上下	高低	優劣	好壞	三六九等	天壤
天壤之別	天壤之別	相去甚遠
存小異	存異
範圍	範疇	規模	框框	圈圈	局面	界	面	圈	層面
勢力範圍	地盤	租界
手心	掌心	手掌	手掌心	魔掌	牢籠	樊籠
省裡	省內
火力網	火力圈
通篇	全文	滿篇	全篇
轄區	管區
方面	上面	上頭	地方	方	面	點	端	者
處處	各方
領域	天地	園地	圈子	世界	小圈子
界	林	苑	壇	系統	戰線
一方面	一邊	一端	一面	一頭	單方面	單	另一方面	一派	單向
雙方	雙邊	兩下裡	兩頭	兩邊	兩	雙面	彼此	二者	兩岸	兩端	兩面	兩手	兩者
多方面	多邊	多方	多頭	絕大部分	大端	大舉
官場	宦海	政界
文學界	文壇	文苑
文藝界	藝苑	藝林	藝界	藝壇
詩壇	書壇
學界	知識界	科學界	教育界	學術界	科技教育界	文化界
借方	收方
戲曲界	梨園
貸方	付方	買方	借貸方
著力點	著力處
前端	前者
負面	陰暗面
商業界	商界
汽車界	汽車業界
各界	各行各業
工商界	工商企業界
社科界	社會科學界
環節	環
系統	系	體系	網
血統	血緣	血脈
分系統	子系統
合作網	協作網
互聯網	互聯網路
觀測網	監測網
互聯網	電腦網
管網	管道網
種類	類別	品類	類型	門類	部類	專案	品種	花色	色	種	類	列	路	檔	型	檔次	檔級	品目
物種	種
新品種	新品
此類	該類
雌雄同體	雌雄同株
雌雄異體	雌雄異株
低高型	高低型
研究型	科研型
結構	構造	組織	佈局
班子	架子	領導班子
梯隊	梯級
建制	體制	編制
次序	次第	程式	順序	次	序	第	先後	先來後到	主次
詞序	語序	語次	音序
席次	座次	坐次	位次
層次	層系
排行	行	橫排	排名	排名榜
流水線	流程	工藝流程
頭一回	首輪	首度	首次
下一場	接下來	然後
本次	此次
白班	日班
行列	行	列	排	班	隊	陣	佇列	序列
一行	一條龍	一溜兒	一人班	單排
雁行	雁陣
工薪層	工薪階層
表面	外表	外部	大面兒	表	標
門面	偽裝	外衣	畫皮	假面具	假相	糖衣	門臉兒
實質	精神	本質	本相	本色	真相	原形	面目	真面目	本來面目	廬山真面目	實為
根本	基本	本	基礎	基業	基石	木本	水源	內核
關鍵	癥結	關子	關節	節骨眼	要點	要害	問題	焦點	樞紐	樞機	刀口	點子	綱	紐帶	主焦點	典型	熱點
地心	地核
核心	中心	重心	本位	重點	基點	主腦	主導	主體	主心骨	關鍵性	著重點	基本點	第一性	側重點	重頭戲	當軸處中	擇要
中樞	心臟	靈魂	命脈
因素	要素	元素	素
成分	分	成份
水分	潮氣
養分	營養	滋養	肥分
標準	基準	準繩	繩墨	准	法	譜	極	準譜兒	定準	規則	規範	條件	原則	尺度	尺碼	準星	格木	參考系	標準化	規格	格	口徑	尺度
準則	信條	訓	圭臬	格言	楷則
榜樣	樣板	樣子	旗幟	規範	楷模	典範	規範	范	師	法	則	體統	金科玉律	指南	楷
好榜樣	表率	模範	楷範
師表	師範	為人師表
垂範	典型
品質	品質	質	質地	身分	色	成色
水準	水準	程度	檔次	品位
高質	品質上乘
基礎	根基	根底	功底	底工	底子	幼功	基本功	底蘊	礎
界限	界線	分界	界	分野	鴻溝	壁壘	格	線	邊境線
只限	限於
下線	底線
限度	限	度	止	邊	止境	底止	限止	界限	窮盡	盡頭	無盡	底限
頂點	頂峰	極限	極點	極端	終極	終點	頂	極	終端	尖峰	巔峰
極致	極了
陰極	負極
正極	陽極
分寸	尺寸	深淺	輕重	高低	大小	輕重緩急	大大小小
分量	斤兩
力氣	氣力	勁頭	勁	力	巧勁	馬力
死力	死勁兒	後勁	牛勁	傻勁兒	忙乎勁兒	勁兒
體力	膂力
腳力	腳勁	腿腳
人力	人工	力士
大力	鼎立	量力
綿薄	犬馬之勞	餘力	鴻蒙
力量	力
生命力	活力	精力	生氣	生機	元氣	血氣	生機勃勃	肥力
勞力	勞動力	半勞動力	全勞動力	壯勞力
視力	目力	眼力	眼神
財力	資力	物力
兵力	軍力	武力
武力	暴力	強力	淫威
法力	佛法
反衝力	坐力	後坐力	反作用力
附著力	黏著力
引力	吸力	吸引力
地心引力	重力	地力	地磁力	磁力
萬有引力	引力
拉力	張力
旁壓力	側壓力	下壓力	上壓力	壓力
內聚力	凝聚力
筆力	骨力
蓬勃生機	勃勃生機
運力	加力	載力
能量	能
勢能	位能
熱能	熱量	汽化熱	潛熱
核子能	核能
名稱	名目	名號	稱號	稱呼	稱謂	稱	名	號
美名	美稱	英名	雅號	徽號
尊稱	大號
愛稱	昵	親愛的
別稱	又稱
俗稱	俗名
名目	名堂
名義	名
幌子	招牌	牌子	旗號	金字招牌
牌子	牌	商標	標記	牌號	招牌
曲牌	牌子	牌	詞牌	詩牌
標題	題目	題名	題
副標題	副題
罪名	帽子
姓名	全名	真名	現名	人名
姓	姓氏	氏	百家姓
複姓	雙姓
貴姓	尊姓
名字	名	諱
大名	芳名
表字	字
小名	乳名	乳名
假名	化名
別名	別號	別字	號
外號	綽號	諢號	諢名
客姓	外姓	異姓
生肖	屬相	十二生肖	十二屬相	十二屬
性別	性
籍貫	籍
原籍	祖籍	老家
戶籍	戶口
川籍	四川籍
資格	身價	身份
出身	身家	家世	門第	門戶
輩分	行輩	輩	世	代	輩數	年輩
吾輩	吾儕
平輩	同輩
上輩	長輩	前輩	先輩
下輩	小輩	晚輩	後輩	小字輩
體格	腰板兒	身板	身子骨兒	筋骨	體魄
身體	人
性格	性情	心性	性子	性	秉性	性靈	脾氣	氣性	脾性	稟性	人性	性氣
天性	個性	秉性	賦性	本性	生性
牛脾氣	牛性	牛勁	牛氣	我行我素
老脾氣	故態
孩子氣	稚氣
品行	品性	品格	品德	德	操守	操行	風操	風骨	行止	操	情操
人格	人品	人頭	人	品質	質地	格調	靈魂	為人
高風亮節	德藝雙馨	誠信
道德	德行	德	道	道義	德性
美德	賢德	賢慧
婦道	三從四德
作風	氣	架子	氣派	派頭	主義	官氣	作派
闊氣	闊	排場	場面	外場
平均主義	大鍋飯	集體主義
利己主義	個人主義
倫常	人倫	五倫	五常	天倫	倫	倫理
孝道	孝	孝心
節操	節	氣節	名節	品節
大節	大德
貞操	貞節
膽量	膽力	膽	膽子	勇氣	種	膽氣	膽略	心膽
魄力	氣魄	魄	膽魄
血性	血氣
氣量	器量	度量	量	心氣	度	心胸	心路	心地	心眼兒	胸襟	胸懷	襟懷	肚量
海量	洪量	雅量
氣概	骨氣	氣	鬥志	士氣
俠骨	鐵骨
智慧	智	慧	慧心	智力	靈性	智商	靈氣
天資	天才	天分	天賦	天稟	稟賦	材	資質
心竅	心勁	悟性	理性
才智	聰明才智	智謀	才分	才思	智略	腦汁	神智
才能	才力	才幹	幹才	才略	才	經綸	才識
才華	才氣	才情	才略	文采	頭角	風華	詞章	德才
奇才	雄才	雄才大略
口才	辯才
文才	筆墨	筆底下	生花之筆	生花妙筆
本領	本事	身手	能耐	能事	能
技術	技能	技巧	技藝	技	藝	術	招術
神通	三頭六臂	神功
特長	專長	絕技	絕招	一技之長	拿手好戲	看家本領	殺手鐧	絕活	絕藝	拿手戲	兩下子	蹬技	奇絕
武藝	本領
舞技	舞藝
球技	球藝	控球技術
高技術	高新技術
戰技術	戰術
能力	力量	力
記憶力	記性	耳性
眼力	眼光	慧眼	鑒賞力	觀察力
功夫	功力	功	素養	造詣
修養	涵養	教養
思想	思	思維	心理
思想意識	觀念	價值觀	傳統	絕對觀念	歷史觀
精神	魂	氣	魂兒	精神上
心思	情思	神思	心神	心腸	神魂	思緒	思潮	心潮
腦子	腦	腦力	頭腦	腦筋	腦瓜子	靈機	枯腸	心力	心血	心機	血汗
腦海	腦際
意匠	匠心	心裁	機杼	機心
思路	思緒	文思	筆觸
上進心	進取心
警惕性	戒心	警惕心
信心	信念	自信心	信心百倍
忌妒心	妒忌心	醋勁兒
感想	感	感觸	感受
內心	心裡	心	胸	衷	心頭	心坎	心房	心魄	心弦	心中	中心	心靈	心扉	心神	心髓	心跡	心底	心目	心尖	心田	心地	心腸	良心	私心	心曲	心眼兒	方寸	寸心	寸衷	衷心	胸臆	肺腑	滿心	心窩子	六腑	心心
居心	用心	存心	心氣	心術	心眼兒	心路	用意	城府
心事	心曲	下情	衷情	衷曲	苦衷	隱衷	隱情	隱私	隱	苦	難言之隱
惻隱之心	慈心
良心	人心	靈魂	心肝	良知
丹心	赤心	紅心	忠心	公心	赤子之心	童心	真心	腹心	心腹	誠心	誠意	至誠	熱血	真情	情素	肝膽	悃	實心實意	真心實意	誠心誠意	忠貞不渝
私心	私念	私	私心	雜念	私心雜念
邪心	賊心	邪念	妄念	非分之想
外心	異心	貳心	二心
黑心	噁心	惡意	禍心	叵測之心
感覺	知覺	神志	感	感性
味道	滋味
同感	共鳴
感情	情愫	情	情感	情義	幽情	真情實意	結	底情	情絲
常情	人情	人之常情
心意	情意	寸心	意思	忱	意
本心	本意	原意
好心	善心	好意	善意	美意	愛心
厚意	雅意	盛意	盛情	深情	深情厚意	敬意
謝意	謝忱
歉意	歉
假意	虛情假意	敵意
心情	情緒	心境	心氣	心緒	意緒	心思	心懷	情懷	心態	心氣兒
豪情	激情
民情	群情	人心	民心	民意	民情	下情	公意	民心向背
世情	人情	世態	人情世故
亢奮	激奮
愛情	情愛	情意	柔情	癡情	愛戀	情網	情	愛意	舊情	含情脈脈
春情	風情	色情	春心	春意	醋意	情竇初開
苦心	苦口婆心
憂心	憂慮	憂愁	愁腸	愁緒	虞
心病	隱痛	隱憂
怒火	怒氣	火氣	火頭	火	氣	怒	閒氣	心火	肝火	無明火	虛火
眾怒	公憤	民憤
不平	夾板氣
怨氣	怨	怨恨	怨尤	怨艾	嫌怨	哀怒
幽怨	幽憤
宿怨	積怨
欲望	欲念	欲	私欲
情欲	人事	性欲	肉欲	春	情
需要	需求	要求	求	需	急需
指望	希望	盼頭	想頭	巴望	望	重托
願望	希望	心願	意願	誓願	願	意	意思	寄意
志願	志
夙願	素願	宿志	宿願	宏願	夙	願心	真意
初願	初衷
意圖	圖	企圖	打算	意向	用意	作用	意	來意	表意
意旨	旨意	意志	法旨	心意	旨在
計畫	規劃	計	方略	藍圖	稿子	打算	算計	猷	謨	譜兒	線性規劃
大計	鴻圖	弘圖	雄圖	雄圖大略	百年大計
小九九	如意算盤
計策	策略	謀略	對策	策	謀	計謀	機謀	智謀	權謀	機關	機宜	心計	心路	預謀	遠謀	策略性	謀計
權術	智術
韜略	戰略	戰略性
巧計	妙計	神機妙算	錦囊妙計	良策	妙策
上策	萬全之策
陰謀	詭計	陰謀詭計	奸計	狡計	鬼胎
毒計	毒謀	惡計
故智	故伎	老一套
手段	手腕	手法	手眼	招數	招	一手	權術	伎倆	心數	心眼
高招	絕招
花招	把戲	噱頭
花頭	花槍	花樣	鬼把戲	怪招
冷箭	暗箭	陰著兒	鬼蜮伎倆	伎	明槍暗箭
辣手	毒手	黑手
理想	志向	志	抱負	心胸	雄心	壯志	雄心壯志	豪情壯志	遠志	篤志	壯心	素志	大志	報國志	扶志	胸懷大志	有志於	雄心勃勃
幻想	空想	玄想	癡想	妄想	白日夢	美夢	春夢	癡心妄想	做夢	理想化	臆想	奇想	隨想
泡影	夢幻泡影	黃樑夢	南柯一夢	一枕黃粱	南柯夢	黃樑美夢	黃粱夢	黃粱一夢	黃粱美夢
夢幻	夢鄉	夢境	夢	睡夢	夢寐	迷夢	睡鄉	夢見
噩夢	惡夢	夢魘
志氣	意氣	心氣	鬥志
意志	心志	毅力	恒心	氣	定性
幹勁	勁頭	闖勁	鑽勁	拼勁	衝勁	實勁
興趣	興味	志趣	趣味	興	感興趣
興致	興會	興頭	意興	心思	勁頭	勁	來頭	胃口	談興	遊興	餘興
意氣	氣味	口味	脾胃
樂趣	生趣	意趣	意	趣	童趣	異趣	野趣	旨趣
詩興	詩思
嗜好	愛好	喜好	癖好	癖	癖性	痼癖	各有所好
癮頭	癮
情致	致	趣	情趣	趣味	意趣	天趣	意味	意思	別有情趣	看頭
韻味	韻致	風味	風致	韻味兒	情韻	氣韻
餘韻	遺韻
想法	想頭	念頭	念	思想	意念	動機	心思	心勁	胸臆	遐思
主意	主見	主心骨	主	意見	呼聲	呼籲	主張
壞主意	餿主意	鬼點子	壞	花花腸子	小算盤
見解	見識	見地	看法	意見	眼光	觀點	觀	見	意	理念	視角
卓見	灼見	高見	遠見	真知灼見	遠見卓識	卓識
創見	新意	創意
定見	定盤星	一定之規	準譜
淺見	管見	拙見	私見	一得之見	一得之愚
成見	入主出奴
偏見	偏	門戶之見	一孔之見	一隅之見	一般見識
異議	異言	異詞	異同	異端	疑念
人生觀	世界觀	宇宙觀
精華	菁華	精髓	粹	精粹	花
寶貝	寶物	法寶	寶	瑰寶	傳家寶	國粹
財富	遺產	寶藏
毫毛	鴻毛	鵝毛	纖毫	涓滴	秋毫之末
贅疣	蛇足	附贅懸疣
糟粕	草芥	糞土	沉渣	殘渣	殘餘	餘燼	遺毒	流毒	殘渣餘孽	污泥濁水
枯木朽株	僵屍
萌芽	胚芽	幼芽	幼苗	嫩苗	苗子	新苗	苗	萌
朝露	曇花
空架子	泥足巨人	繡花枕頭
大雜燴	雜燴	雜拌兒
阻力	阻礙	障礙	攔路虎	絆腳石
屏障	遮罩	遮擋	掩蔽	隱身草	遮羞布	煙幕彈	障子	風障	籬障
擋風遮雨	遮風擋雨
枷鎖	約束	管束	束縛	羈絆	桎梏	緊箍咒
誘餌	糖衣炮彈	糖彈
圈套	鉤	牢籠	陷阱	騙局
護身符	護符	保護傘
途徑	路徑	門徑	蹊徑	路	門路	門道	路線	路子	路數	不二法門	乾路
道路	道	途程	征途	征程
長征	萬里長征
正路	正道	正軌
坦途	陽關大道	康莊大道
邪路	邪道	歪門邪道	旁門左道	左道旁門	歪道	歪路
後門	方便之門
歧路	歧途	迷津
老路	覆轍	套路	套數
絕路	末路	死胡同	窮途末路	死路
近路	捷徑	終南捷徑
半路	半途	中途	中道
後路	後手	餘地	退路	逃路
階	階梯	臺階
敲門磚	墊腳石
致富線	富民路	致富路
神	神仙	神人	神物	神道	神明	神靈	菩薩	仙人	仙
造物主	上帝	天	天神	天公	蒼天	上天	皇天	老天爺	真主	盤古
女神	神女	仙姑
仙女	仙子	天仙
聖母	娘娘
天使	安琪兒
上帝	耶和華
基督	耶穌	救世主
佛陀	佛	佛爺	浮屠	阿彌陀佛	彌勒佛	強巴阿擦佛
西王母	王母娘娘
觀世音	觀音	送子觀音
財神	財神爺	趙公元帥	過路財神
閻羅	閻王	閻羅王	閻王爺
土地	土地老	土地爺
灶神	灶君	灶王爺
凶神	兇神惡煞
鬼	鬼魂	死鬼	異物
魔鬼	魔	撒旦	鬼魔	鬼神	死神	厲鬼
惡鬼	魔王
妖	妖怪	妖精	妖魔	邪魔	妖物	怪物	精	怪	精怪	精靈
狐仙	狐狸精	異類	異物	白骨精
魂	魂靈	靈魂	魂魄	神魄	心魂
陰魂	幽魂	幽靈	亡靈	亡魂	鬼魂	在天之靈
英魂	英靈	忠魂
妖魔鬼怪	魑魅	魍魎	魔怪	鬼怪	鬼魅	鬼蜮
神怪	神異
天國	天堂	上天	淨土	西天	西方	極樂世界
天宮	玉宇
月宮	蟾宮
龍宮	水晶宮
陰間	陰曹	冥府	黃泉	九泉	九泉之下
前生	前世	上輩子
來世	來生	下世	下輩子
龍	蒼龍	龍身	鳥龍
蛟龍	蛟	飛龍
虯龍	虯
鳳	鳳凰	百鳥之王	凰	金鳳凰	鸞
麒麟	麟
世界	世	世上	大地	天下	天底下	全世界	環球	全球	舉世	中外	寰宇	五洲	海內	海內外	五湖四海	大千世界	大世界	普天之下
第三世界	第三國際
人間	人世	人世間	世間	陽間	塵世	塵寰	塵俗	紅塵	塵	凡	下方	濁世	花花世界	凡間	江湖
國家	國	邦	國度	江山	社稷
全國	通國	舉國	舉國上下
中原	華夏	中華	華	赤縣	神州	九州	赤縣神州	炎黃	中國	禮儀之邦
盟國	盟邦	盟友	聯盟	同盟國	友邦	盟軍
外國	外	外域	異國	異邦	異域	夷	別國
鄰國	鄰邦
萬國	列國	國際
大國	泱泱大國	雄	強	強國	超級大國	大公國	列強
共和國	民主國
王國	帝國	君主國
主權國	獨立國	獨立國家	獨立王國
屬國	藩國	藩屬	藩	附屬國	附庸	殖民地	所在國	債務國	債權國
聯邦	邦聯	阿聯酋	合眾國
本國	我國
省	省份	省區
縣	邑	旗	宗	版納	縣城	縣份	試點縣
鄉	鎮	鄉鎮	民族鄉	鄉鄉鎮鎮
我省	本省
本縣	我縣
東洋	東瀛	支那
各州	全州
地縣	市縣
首都	國都	京都	都城	京城	上京	京	都	京師	京華	鳳城	北京	北京市
故都	舊都	舊國
省會	省城	首府	省府
人種	種族	種
民族	族	全民族	部族	中華民族
外族	異族	異教
蒙古族	蒙族
哈薩克族	哈薩克
客家人	客家
門巴	門巴族
家族	親族	家門	族	宗	房
皇族	皇室	皇家	金枝玉葉
王室	王族
望族	世族	世家	大家	門閥	權門	豪門	名門	朱門
大族	大戶	大姓	大家族
門第	門戶	門楣	家門	門	戶
家庭	家園	人家	家	門	家家	家中
全家	闔家	闔家	一家子	本家兒	全家人
書香人家	詩禮之家	書香門第	詩書門第
寒門	柴門	蓬門蓽戶	蓬戶甕牖
娘家	岳家
婆家	人家
住戶	人家	戶	家	人煙	宅門	每戶	住家	居家	村戶
農戶	莊戶	農家	農戶家
富戶	首富	豪富	大戶	富裕戶
小康	小康戶
小戶	小戶人家
舍間	捨下	下家	寒門	寒舍
單門獨戶	獨門獨戶
戶頭	戶
階級	階級性
無產階級	工人階級
政黨	黨	黨政
共產黨	共	黨	中共	中國共產黨	國共
政治	政	法政
朝政	時政	政局	大政	黨政	憲政	國政	新政
仁政	德政	王道
暴政	虐政	苛政	霸道	霸氣
帝國主義	帝
法西斯主義	法西斯
機會主義	冒險主義
帝制	君主專制
議會制	代議制	多黨制
專政	獨裁
政策	策略	策	國策	方針	同化政策
制度	制	社會制度
國際公制	公制	米制	國際制
市制	市用制	土制
徵兵制	軍制	兵役制
募兵制	志願兵制
所有制	國體
個體所有制	個體戶	私人佔有制	非公有制
非公有	非國有
三資	三資企業
國有	公有
體制	建制	編制	單式編制	機制
機構	組織
部門	單位
會計室	帳房	財務科
教研室	教研組
工段	段
核查組	檢查組	調查組
維修班	修理班	搶修班
專修班	研修班	進修班
春蕾班	女童班
輔導班	補習班
訓練班	培訓班
研討班	研習班	講習班	研究班
支部	分支部
關係部	公關部
團體	組織	集體	夥	社	團	團隊	團夥	集團	團組織
陣營	陣線	營壘	同盟
紅十字	紅新月會
群落	部落	群體
黑社會	黑幫
本社	我社
派別	派系	宗派	門戶	山頭	流派	派	家	宗	門	幫派	船幫	法家
嫡派	嫡系	正宗	正統派
支派	支系	分支	旁支
左派	左翼
右派	右翼
軍隊	武裝部隊	武裝力量	武裝	部隊	隊伍	人馬	大軍	三軍	軍	師	旅	戎	槍桿子	武力	行伍	兵馬	軍事	槍桿	軍旅
雄兵	雄師	重兵	天兵	鐵流	勁旅	堅甲利兵
貔貅	貔虎
海軍	水軍	水師
傘兵	空降兵
子弟兵	國民軍	人民軍
解放軍	人民解放軍	中國人民解放軍	紅軍	革命軍
志願軍	中國人民解放軍	八路軍	八路
義師	義軍	義勇軍	共和軍
衛隊	禁軍	御林軍	近衛軍	赤衛隊	赤衛軍	守軍	自衛隊	中軍	清軍	自衛軍
前鋒	先鋒	先遣隊	開路先鋒
兩翼	翼側
援軍	救兵	後援
戰爭	戰事	戰亂	戰禍	煙塵	戰火	烽火	烽煙	狼煙	兵火	兵燹	刀兵	兵戈	干戈	戰	仗	亂	大戰
戰役	役
激戰	苦戰	鏖戰	鏖兵	鏖鬥
殊死戰	死戰	血戰	硬仗
塹壕戰	壕塹戰
閃電戰	閃擊戰
破擊戰	破襲戰
初戰	首戰	此戰
奮戰	苦戰
內戰	內亂
宗教	教
道門	道	壇	道家
佛教	佛門	佛	空門	禪宗
天理教	八卦教
基督教	新教	耶穌教
天主教	舊教
東正教	正教
伊斯蘭教	清真教	回教	伊斯蘭	清真
婆羅門教	印度教
禮儀	儀式	儀	式	禮	典	典禮	慶典	儀仗
盛典	大典	國典
洗禮	洗
繁文縟節	殯儀
禮節	禮數	禮俗	儀節
禮貌	禮數	形跡	禮	無禮	多禮
虛禮	俗套	虛文
風俗	俗	風	習俗	民俗	風土	人情	風土人情	風俗習慣	傳統	風俗人情	風土民情	謠風	遺俗
習慣	習氣	積習	習
陋習	惡習	習染	沉痼	痼習	陋俗	固習	舊俗	舊習
風氣	風尚	風	風習	習尚	新風
時尚	俗尚
家風	門風
世風	世道	世界	社會風氣
妖風	邪氣	歪風邪氣	不正之風	歪風
地位	位置	身價	身分	位
要津	要路
高位	上位	青雲	要職
名位	名分	排名分
職位	位置	職	崗位	哨位	職務
職守	職掌
差使	差事	職分
官職	功名	前程	烏紗帽	烏紗
崗	哨卡
等級	等第	等次	等差	級次	級差	等	級	號	流	路	階	星等	品級	品	階段
頭銜	銜	職稱	職銜
設計家	設計師
帝位	大寶	位	基	祚
爵位	爵
公爵	公
侯爵	侯	萬戶侯
伯爵	伯
子爵	子
男爵	男
事業	業
大業	偉業	宏業
行業	行	業	行當	本行	同行業	正業
七十二行	三百六十行	三教九流	九流三教	各行各業	五行	農工商
商業	商	生意	買賣	商貿	經貿	小買賣	小本生意	小本經營
工程	工	工事
水利工程	水利	水工	河工
土木工程	土木
職業	工作	營生	事情	生意	生業	飯碗	差事	事	業	差	專職
兼職	兼差	專兼職
工作	作業	業務	事務	事情	事體	務	政工
勤務	勤
總務	庶務	報務
野外工作	田野工作
活計	活路	活	生活	勞動	體力勞動	活兒
家務	家事	家務活
針線	針線活
手工	細工	手活
農活	農事	春事	莊稼活兒	農務
勞役	苦工	徭役	烏拉	賦役	徭役地租	苦差	苦活
動作	手腳	小動作
著數	招數	路數	招	招法
舉動	行動	舉措	舉止	行徑	一舉一動	言談舉止	此舉
善舉	善事	善	好事	孝行	好鬥
陰德	陰功	陰騭
惡	惡行	倒行逆施
私弊	藏掖	陰私	毛病
行為	行止	作為	行事	表現	行	所作所為	一言一行
暴行	橫行	橫逆	暴舉
惡行	倒行逆施
權力	權柄	權	柄	印把子	權能	權位	許可權	權杖
政權	政柄	大權	統治權	領導權
軍權	兵權	王權
職權	事權
權利	權
財產權	產權	物權
責任	責	事	專責	義務	總責	權責	總任務
重任	使命	沉重	大任	千鈞重負
職責	天職	職分	職掌	任務
本分	己任	本本分分
負擔	擔子	包袱
重負	重擔	三座大山
會議	會	集會	議會
茶話會	茶會
党代會	黨代表大會
代表大會	代表會
宴會	酒會	宴	便宴	家宴	歌宴
盛宴	國宴	鴻門宴	慶功宴
喜筵	喜酒	喜宴	滿堂吉慶宴	婚宴
酒席	宴席	筵席	席面	席	筵宴	歡宴	酒宴
素席	素酒
規則	守則	準則	則	規	律	章法	軌道	清規戒律	規例	規約
章程	規章	條例	條條	章	例	典章
規定	規程
規矩	軌	繩墨	矩
常規	成規	定規	分規
空文	一紙空文
陋規	陳規	陳規陋習
條約	公約	約
協定	存照	協議書	協約	總協定
約據	契約
盟約	盟誓	宣言書
合同	合約
契	契據
保證書	保證	責任書
條款	條目	章	條規	條令	條文	條條框框
法律	法度	刑名	律	法	法網	王法	法規	法例
法制	法紀	紀綱	綱紀
憲法	憲	根本法	大法
法令	憲	政令	法案	法治
刑法	刑律	刑事
此法	本法
紀律	紀
禁	戒	禁例	律令
戒律	戒條	天條	清規戒律
罪行	罪名	罪過	罪	辜	孽	罪孽	罪惡	滔天大罪	彌天大罪	餘孽	冤孽	作孽
刑罰	刑	徒刑
刑法	刑
從刑	附加刑
大刑	重刑	毒刑	酷刑	嚴刑
死刑	極刑	死罪	死緩
淩遲	剮
經濟	財經	金融
上市	掛牌
價值	價	值
價格	價錢	標價	價	價位
行市	行情	盤子	盤	物價指數
價目	價碼	報價
不變價格	比較價格	可比價格
產業	產	業	產業群
財產	資產	財
家產	家當	家業	家私	家事	家底	箱底	產業	家財	祖業
動產	浮財
不動產	恆產
私房錢	私房
財物	財	財富
錢財	資財	銀錢	金錢	錢	財帛	貲	資	金	長物
洋財	橫財	外財	儻
邪財	橫財	不義之財
民脂民膏	血汗錢
資本	資產	資金	本金	基金	本錢	股本	老本	血本	本	財力	成本	工本
股份	股子	股	股金	股份
財政資本	金融資本	貨幣資本
壟斷資本	獨佔資本
利潤	贏利	盈利	利	賺頭	創收	淨收入	淨利潤	純利潤	實利
紅利	花紅	紅
純利	淨利
股息	股利
利息	利錢	子金	利	息	利息率	收息率
年利	年息	年利率
月利	月息	月利率
高利貸	印子錢	印子
高利	重利
債務	債	帳
宿債	積欠
呆壞賬	壞賬
貨幣	錢幣	通貨	錢	幣	圓	元	泉
紙幣	鈔票	鈔	票	票子	紙票
輔幣	補助貨幣	輔助貨幣
銀元	銀洋	洋	洋錢	光洋	現洋	現大洋	大洋	花邊	袁頭	大頭	鷹洋	金元	銀圓	元寶
角票	毛票
銅元	銅錢	銅板	小錢	銅鈿	錢	子	文	銅幣
大錢	大
金條	條子	黃魚
銀兩	銀子
票據	票	券
匯票	外匯券	券別
印花稅票	印花	稅票
郵票	郵花	紀念郵票
聯運票	通票
有價證券	證券
獎券	彩票
公債券	債券	國債券
捐稅	捐	稅	課	花消	稅金	稅捐	稅款	稅利	稅收	稅賦
田賦	錢糧	租
苛捐雜稅	苛雜
租金	租	租稅
工資	工錢	工薪	薪資
薪水	薪金	薪給	薪俸	薪	薪餉
月薪	月工資
軍餉	餉	糧餉
俸祿	祿
津貼	補貼	貼
報酬	酬勞	酬金	待遇
工錢	手工錢
稿費	稿酬	版稅
潤筆	潤資
傭金	傭錢	傭	花消	回扣
腳錢	腳力
帳目	賬	帳面	帳目
日記帳	日記帳
明細帳	細帳	明細帳	細帳
款項	款子	頭寸	款	錢	項	帳
公款	帑
現款	現錢	現金	現鈔	碼子	現
進項	進款	收入	收益	純收入	入帳	創匯	獲益	低收入
收支	進出
盈餘	贏餘	餘剩	剩餘	結餘	存欄	存項
虧損	虧空	赤字	窟窿	下欠	尾欠
損耗	虧耗	消耗	傷耗
損益	盈虧
公積金	公共積累
罰金	罰款
存款	儲蓄
頭寸	銀根
外快	外水
保證金	保險金	抵押金
賠償金	賠償費	補償費	補償金
補助金	補助費
成本費	工本費
修理費	維修費
通話費	電話費	話費
代理費	代辦費
教育事業費	教育費
費用	費	用	用度	用費	花費	用項	支出	開支	開銷	花消	花銷	資費
生活費	日用	家用
伙食費	膳費	飯錢	餐費
學費	學雜費
郵費	郵資
路費	旅費	盤纏	川資	旅差費	差旅費
車錢	車馬費	交通費	車費
運輸費	運費
小費	茶錢	茶資	酒錢
賞錢	喜錢
零用	零花	零錢	月錢	零花錢	零用錢	零用費
撫恤金	恤金	優撫金	慰問金
文化	文明	雙文明
仰紹文化	彩陶文化
教育	教	教養
電化教育	電教
興學	辦學
衛生	保健
學說	主義	思想	理論	論
馬克思列寧主義	馬列主義
唯物主義	唯物論	唯物
歷史唯物主義	唯物史觀
唯心主義	唯心論	唯心
形而上學	玄學
達爾文主義	進化論
中學	國學	舊學	東方學
學問	學	墨水	學術
知識	知	學問	學識	文化
見識	見聞	識	耳目	眼界	膽識	所見所聞	有膽有識	視界	學海	識見
科學	學
社會科學	人文科學
邏輯學	論理學
音韻學	聲韻學
語法學	文法學
醫學	醫術	醫道
中醫藥學	中醫學	中藥學
學科	課	科目	課程	教程
語文課	國語課
數學課	算術課
理化	生化
外語課	外文課
體育課	體操課
醫學	醫
中醫	國醫
小兒科	兒科
牙科	口腔科
學業	課業	功課	作業
習題	練習	練習題
課外作業	家庭作業
題目	問題	題
考題	課題	考試題	試題
難題	偏題
考卷	試卷	卷子
號碼	號子	號	碼	碼子	數碼	編號
郵遞區號	郵編
條碼	條碼
記號	符號	號子	標記	標誌	符	記	號
花押	押
杠子	杠
曲譜	譜	譜子
標點符號	標點
逗號	逗點	逗
句號	圈
頓號	點
感嘆號	驚嘆號
刪節號	省略號
字	文字	文	言	契	仿	親筆
漢字	中國字	方塊字	單字	字
俗字	卜辭
古文字	古文	古字
簡體字	簡化漢字	手頭字	簡寫
數目字	數字
金文	鐘鼎文
大篆	籀文	籀
小篆	秦篆
隸書	隸字	今文
楷書	正書	真書	正楷	楷
朱文	陽文
白文	陰文
別字	白字
盲文	盲字
筆劃	筆	畫	筆劃
橫	畫
豎	直	一直
挑	剔	提
捺	磔
偏旁	旁
寶	蓋	兒	寶蓋頭
字母	假名
書體	字體	書	字
正體	正字
篆書	篆體	篆字	篆文	篆
隸書	隸
楷書	正楷	楷體	工楷	正字	正體	真
宋體字	老宋體	宋體
仿宋體	仿宋
草書	草體	草字	草	行草
小楷	小字
大楷	大字	寸楷
詞	單詞	字眼	字	單字
詞語	用語	辭藻	辭
字句	詞句
片語	短語
詞彙	語彙
褒義詞	褒詞
貶義詞	貶詞
措辭	用語
冗詞	冗詞贅句
諺語	諺
語助詞	語氣助詞
單純詞	單詞
句	句子	語句	文句	詞	句
佳句	妙句	絕句	清詞麗句
名句	警句	語錄	座右銘
語言	言語
漢語	華語	國語	中文	國文	漢語言
外國語	外語	外文
方言	土語	土話	地方話	白	白話
普通話	國語	官話
文學語言	標準語
文藝語言	文學語言
謎語	謎
令	酒令
題材	題目	問題
主題	正題	本題
體裁	樣式	體	體制
佈局	格局	佈置
情調	色彩
格調	筆調	調子	調頭
俗套	老套子	老調	窠臼
風格	風骨	標格	品格	作風
筆勢	筆致	文筆
球路	歌路
音律	樂律
目錄	目次	目	索引	引得
書目	書錄
細目	子目
戲目	戲碼	曲目
節目	劇碼
內容	情節	情	本末	始末
細節	底細
字裡行間	字字句句
意思	意
意味	寓意	味道	含意	命意
詩情畫意	詩意
口氣	口風	口吻	話音	語氣	音	文章	言外之意	弦外之音
要點	要端	要義	要	要領	大要	中心	中心思想
摘要	撮要	提要
綱要	提綱	大綱	總綱	綱領
概要	梗概	概略	大概	大意	大旨	大校	大略	要略
話	言	語	談	言語	言辭	說話	講話	話語	語句	話頭	口舌	唇舌	辭令
談吐	措詞	出言
談鋒	話鋒
話頭	話鋒
片言	片言隻字	隻言片語	片言隻語
至理名言	至理明言
豪語	豪言壯語
空話	空談	侈談	空論	空炮	白話	空頭支票
牛皮	高調	大話	狂言	漂亮話
真話	真心話	實話	肺腑之言	由衷之言	心聲	衷腸
知心話	私話	私語	私房話	床第之言
常言	常言道
家常話	家常
家鄉話	鄉談
口頭禪	口頭語
客套話	客套	套子	套語	應酬話	寒暄語
門面話	官話	官腔
現成話	濫套子	老套子
俗話	俗語	常言	語	民間語
老話	古語
諾言	約言	諾	宿諾
誓詞	誓言	誓
咒語	咒	符咒
口訣	歌訣
訓詞	訓話	訓	指示	訓示
勸告	忠告
忠言	箴言	諍言	真言
遺言	遺教	遺訓	古訓
耳邊風	耳旁風
婉言	婉辭	軟語	好話	祝語
好話	感言	錚錚誓言
美談	佳話
讚語	美言	客氣話
祝詞	賀詞	頌詞	口碑
笑話	玩笑	噱頭	戲言
讒言	讒
清淡	玄
高帽子	高帽兒
甜言蜜語	花言巧語	迷魂湯	迷魂藥
怨言	牢騷	怪話	閒話	微詞	閒言閒語	冷言冷語	滿腹牢騷
流言	流言蜚語	風言風語
胡話	妄語	瞎話	謬論	不經之談
怪話	怪論	海外奇談	奇談怪論
謊話	謊	謊言	假話	鬼話	欺人之談	彌天大謊
閒談	閒話	閒扯
絮語	車軲轆話
贅言	廢話	冗詞贅句
粗話	髒話	下流話	猥辭	惡語	惡言
說白	道白	念白	白
引子	開場白
臺詞	戲詞	戲文	詞兒
回話	回音	回信
夢話	夢囈	囈語
急口令	繞口令	繞口令
口號	標語
切口	黑話	隱語	暗語
口供	供詞	供	交代
寡言少語	少言寡語	寡言
一番話	一席話
此言	此話
說法	講法	提法
言論	論	議論	談話	發言
老調	濫調	陳詞濫調	老生常談
論調	調調
講經說法	論道
評論	評說	述評	評述	評	闡
輿論	輿情	公論
眾說	雜說	議論	街談巷議
估測	測評	評測
建議	提議	動議	提案	決議案	建議書
結論	定論	斷案	斷語	敲定	談定	下結論
決定	決議	定案
命令	命	令	號令	勒令
軍令	將令
指令	訓令	指示	訓示	諭
聖旨	諭旨	旨意	詔書	上諭	旨	詔	敕	誥
兵符	符
通知	通牒	通報
佈告	通告	通令	文告	告示	榜	榜文
檄文	檄書	檄
啟事	告白	揭帖	字帖
喜報	報單
光榮榜	紅榜
訃告	訃聞
報告	彙報	呈文	呈子	簽呈	諮文	條陳
奏章	奏疏	章	表	本	疏	書
便條	條子	條	便箋
回條	回帖	回執	回單
招貼	招子
簽	浮簽	標籤	標價簽	價簽	竹簽
皮帶	小抄兒
病假條	假條
處方	配方	方子	方	藥方	方劑
單方	丹方	偏方	土方
成方	驗方
說明書	仿單	說明
信	函	劄	書	簡	箋	鴻	翰	書信	信劄	書劄	書簡	書函	尺牘	八行書	雙魚	鯉魚	鴻雁	緘
家信	家書	竹報平安
來信	來函	來鴻
回信	覆信	回音	玉音
賀信	賀函
手書	親筆信
黑信	恐嚇信
公函	文牘	授信
信件	函件	信稿
檢舉信	舉報信
感謝信	表揚信	感謝狀
邀請函	邀請信	邀請書
投訴信	上告信	信訪件	上訴書
電報	電	報
傳真電報	傳真
加急電報	特急件
資料	材料	材	素材	骨材
檔	文書	文本	公文	公事	文牘	等因奉此
檔案	檔
案卷	案
卷宗	卷
照會	照
判決書	判詞
悔過書	檢討書	檢查
訴狀	狀子	狀	起訴書
供狀	供詞	筆供	供
遺囑	遺書
修改案	修正案
抄件	影本	影印件
圖	圖形	圖樣	圖片	圖紙	圖表	圖籍
地圖	地形圖	地質圖
正視圖	正面圖	主視圖
側視圖	側面圖
頂視圖	俯視圖
頻譜	頻帶
表	表格	報表
視力表	目力表
正誤表	勘誤表
坐位表	座位表
課程表	課表
作品	作	創作	著作	著	著述	撰述
巨著	鴻篇巨制	大作品	巨制
傑作	佳作	大作	雄文	神品	名著	大筆	大手筆	墨寶	絕唱	香花	壓卷之作	絕響	名作	名篇	力作	大作品
處女作	出世作
拙作	拙筆	拙稿
急就章	即興之作
遺著	遺書	遺墨	遺稿	絕筆	遺文	遺作
手跡	手筆	真跡	墨	墨蹟
斷編殘簡	片紙隻字	殘篇斷簡
文章	篇	章	篇章	成文	筆劄	稿子
社論	社評
論文	輿論
八股文	制藝	時文	八股
劄記	摘記	筆記	側記
祭文	誄	悼詞	哀辭	挽詞	禱文	挽辭
碑文	碑記	碑誌
墓碑	神道碑
墓誌	墓誌銘	銘文
行狀	行述
文言文	文言	古文
白話文	語體文
應用文	實用文
記敘文	敘事文	敘文
說明文	論說文
駢文	四六文	詩作
上下文	前後文
辭章	詞章
下卷	下篇
稿件	稿子	稿
草稿	草	稿	文稿	算草
初稿	未定稿	長編	原稿	原文
底稿	稿本	底	底子	書稿
書籍	書本	書	圖書	書簡	經籍	本本	書冊	漢簡	木簡
叢書	叢刊	叢刻	文庫
四庫	經史子集	四書
曆書	通書	黃曆	老皇曆	故紙
史書	史籍	史冊	青史	史	汗青	竹帛	簡本	簡編	封志
兵書	兵符
古書	古籍	舊書
經書	經籍	經	經典	典籍	大藏經	真經	經卷
方志	地方誌
集子	集
讀本	課本	教科書	教本	教材	講義
字帖	習字帖	帖
畫帖	畫譜
連環畫	小人兒書	娃娃書	兒童書	小人書
書背	書脊
版本	本子	本	版
珍本	秘本	秘笈	孤本
樣本	範本	模本	樣書	樣張
正本	原本	底本	底冊	藍本
副本	複本	抄本	寫本	摹本	翻刻本
頁張	頁
封面	封皮	書皮	書面
報章	報紙	報
壁報	壁報
雜誌	期刊	刊物	刊	報
週刊	週報
特輯	特刊	專輯	專刊	專號	專欄
報刊	報章雜誌
書刊	書報
序言	序文	前言	題詞	花序
引言	小引
導言	緒論	楔子
本文	正文	白文
結語	結束語	尾聲	煞筆
跋	跋文	後記	書後
序跋	題跋
按語	按	案語	編者按	編者案
批語	批	批示	朱批
眉批	批註
引文	引語
注解	注釋	注腳	注
凡例	例言
備考	備註
經典	經	經典著作
經文	經典	經	藏
佛經	釋典	釋藏	古蘭經	聖經	十三經	金剛經	石經	六經	三字經
舊約	新約
文學	文藝
新文學	白話文學
口頭文學	說唱文學	民間文學
小說	小說書	閒書
劇本	臺本	腳本	本子	院本
散文	散記
小品	小品文
漫筆	隨筆
傳記	傳	傳略	事略	文傳
雜記	筆記	筆錄	筆談	雜誌	記	側記
記錄	記要	紀錄	紀要
報導	通訊	簡報	報導
日誌	日記
圖說	圖鑒
紀行	遊記	剪影	掠影
訪問記	採訪記
詩	詩歌	詩篇	詩文	詩抄	詩詞	詩句	詩選	詩章
古體詩	古詩	古風	古
史詩	詩史
律詩	律
絕句	絕
舊詩	舊體詩
新詩	白話詩
民歌	民謠	歌謠	風	風謠	俚歌
兒歌	童謠
讚美詩	讚美歌	讚歌	頌歌
即興詩	口號
詞	長短句	樂章	歌詞	鼓子詞	宋詞	繇
賦	辭賦
令	小令
曲	散曲	俳句
對聯	楹聯	聯
門聯	門對
對子	對
春聯	桃符
音樂	樂
下里巴人	民樂
交響樂	交響詩
歌	歌曲	曲
情歌	戀歌
哀歌	悲歌
夯歌	號子
船歌	船夫曲
曲	曲子	樂曲
序曲	前奏曲	引子	過門兒
尾聲	煞尾
小調	小曲
催眠曲	搖籃曲
戲劇	戲	劇
戲曲	曲
歌劇	歌舞劇	舞劇
話劇	文明戲
京劇	京戲	大戲
昆劇	昆曲
婺劇	金華戲
越劇	紹興戲
粵劇	廣東戲
豫劇	河南梆子
秦腔	陝西梆子
晉劇	山西梆子
閩劇	福州戲
評劇	落子
滬劇	申曲
淮劇	江淮戲
鬧劇	笑劇	鬧戲
武戲	武劇
木偶戲	傀儡戲	杖頭木偶
皮影戲	影戲	驢皮影	影
看家戲	拿手好戲	保留劇目
唱段	選段
唱腔	腔調	聲調
昆腔	昆曲
梆子腔	梆子
二黃	二簧
舞蹈	舞	俳
芭蕾舞	芭蕾
龍舞	龍燈
跑旱船	採蓮船	大秧歌
太平鼓	羊皮鼓
電影	影戲	影	影片	影視	錄影
無聲片	默片
動畫片	卡通	動畫	卡通片	木偶劇
音像	聲像
鏡頭	畫面	映象
廣角鏡頭	長鏡頭	慢鏡頭
大鼓	鼓書
鐵板大鼓	鐵皮大鼓
道情	漁鼓
蓮花落	落子
說書	說話	評書	評話
評彈	彈詞
滑稽戲	獨腳戲	獨角戲
河南墜子	墜子
雜技	把戲	雜耍
魔術	幻術	戲法
武術	國術	武藝	武工	拳棒	把勢	把式	武
柔道	柔術
拳術	拳腳	拳
繪畫	美術	圖畫	畫圖	丹青	畫	圖	美工	畫片	圖案	圖騰	畫畫
插畫	插圖
國畫	中國畫
西洋畫	西畫
漫畫	卡通
宣傳畫	招貼畫
屏條	屏
木刻	木版畫
字畫	書畫	墨寶	翰墨	冊頁
雕刻	雕像
塑像	泥塑	泥胎	塑像	微雕
佛像	佛
照片	相片	照	影	肖像	像
小照	小影
遺照	遺像	遺容	神像	真影
全家福	闔家歡
像	形象	影像
畫像	肖像	真影	寫真	實像
疾病	病症	病魔	病痛	毛病	疾患	症候	病	疾	症	恙	屙
沉屙	沉痼	痼疾	頑症
急症	急病	暴病
險症	重症
絕症	死症	不治之症
瘟疫	疫病	疫癘	瘟	疫	癘
時令病	時令
併發症	合併症
內傷	暗傷
炎症	炎
結核病	結核	癆病	癆
精神病	神經病
性病	花柳病
梅毒	楊梅
貧血	血枯病
肺結核	肺病	肺癆
塵肺	灰塵肺
胸膜炎	肋膜炎
肝硬變	肝硬化
瘧疾	冷熱病	瘧	瘧子	出血熱	登革熱病	風疹
傷寒	腸傷寒
霍亂	虎疫	絞腸痧	痧
痢疾	痢
變形蟲痢疾	阿米巴痢疾	銀屑病
流行性感冒	流感
中暑	日射病	痧
對眼	鬥眼
麥粒腫	針眼
青光眼	內障
白內障	內障
斑禿	鬼剃頭
麻風	癩	小兒麻痹症	痹症
蕁麻疹	風疹塊
濕疹	濕氣
白癜風	白斑病
癔病	歇斯底里
腦炎	大腦炎	暑瘟
癲癇	羊癲瘋	羊角風	癇
癱瘓	瘋癱
產褥熱	月子病
闌尾炎	盲腸炎
流行性腮腺炎	痄腮
絲蟲病	血絲蟲病	粗腿病
鼠瘡	瘰鬁
高山病	山暈
疝氣	小腸串氣
呆小症	克汀病
走馬疳	牙疳
不孕	不孕症	不育症
失眠病	失眠症
愛滋病	愛滋病
風濕	類風濕
甲亢	甲亢病
婦科病	婦女病
舊病	老毛病
牛瘟	爛腸瘟
黑穗病	黑粉病
黃銹病	黃疸	葉銹病
銹病	鏽
外傷	金瘡	創傷	傷口	瘡	花
帶傷	有傷
傷口	創口	口子	患處
腫瘤	瘤	瘤子	肉瘤
毒瘤	惡性腫瘤	癌	癌腫	癌瘤	癌細胞	根瘤	癌魔
癬	頑癬
頭癬	禿瘡	癩	瘌痢	癩癬
花斑癬	汗斑
手癬	鵝掌風
腳癬	腳氣
瘡	瘍
疥瘡	疥
癰	癰疽
疔	疔瘡	瘡
砍頭癰	砍頭瘡
膿包	膿腫
癤子	癤
痂	瘡痂
痔	痔瘡
趼子	趼	胼胝
痣	痦子
癍	斑痕
壽斑	老人斑	老年斑
記	胎記
粉刺	痤瘡
雀斑	黃褐斑
疣	肉贅	瘊子	贅疣	贅瘤	臀疣
疙瘩	圪塔	包	疹	塊	腫塊	疹子
繭	繭子	老繭
政府	內閣	閣	當局	朝
機關	機構	單位	部門
看守內閣	看守政府	過渡內閣
朝廷	宮廷	廟堂	王室	朝	廷	皇朝	清廷
官府	官廳	官署	官衙	衙門	衙署	衙	縣衙	清水衙門
樞要	樞機
行政公署	行署	公署
大使館	使館	領館	分館
總領事館	總領館
總政治部	總政
計生委	計委
國家教委	教委
中央軍委	軍委
航天局	宇航局
國稅局	稅務局
林管局	林業局
物資局	國資局
郵電局	郵局
高法	最高人民法院	最高法院
檢察院	人民檢察院
法院	人民法院
法庭	庭
公安局	警察局	局子	派出所	公安部	警方	巡捕房	警署	警備部	員警署
監獄	牢獄	牢	監	獄	監牢	大牢	囚牢	監獄	牢房	看守所	囹圄	鐵窗	鐵欄杆	地牢	囚室	水牢	禁閉室	囚籠	拘留所
工廠	廠子	廠
礦	工礦
工廠	作坊	作	坊	房	小器作
磨坊	碾坊	磨房
醬園	醬坊
商店	鋪子	店鋪	鋪戶	店家	商行	商號	店	鋪	號	莊	局	肆	櫃	公司	洋行	代銷店	店堂	供銷社	小賣部	信用社	商社	商廈	鋪面	營業所	合作社	商家	企業
總店	總行	總公司	母公司	總局
分店	分行	分號	支店	分公司	子公司	支行	孫公司
攤	攤子	地攤	貨櫃	貨攤	攤點	攤位	炕櫃	路攤	門市部	小攤	攤兒	攤檔
中藥店	藥鋪	藥材店	草藥店	藥店
西藥店	藥房
書店	書局	書鋪	書攤	書報攤
理髮店	理髮館	理髮廳	美髮廳	髮廊	美容美髮店	美髮店	理髮室	美容院
飯店	飯館	飯鋪	飯莊	菜館	館子	酒家	酒館	食堂	餐館	飲食店	餐飲店
酒店	酒家	酒吧間	酒樓	酒館	大酒店	酒吧	國賓館	小吃攤
小吃店	小吃部
旅館	店	旅社	客店	客棧	旅舍	招待所	下處	公寓	賓館	行棧	旅店
茶館	茶樓	茶社	茶坊	茶室	茶堂
當鋪	當	典當	押當
裁縫店	成衣鋪	服裝店	時裝店
布店	布莊
雜貨店	雜貨鋪	百貨店	百貨公司	百貨商店	商城	超市
浴室	浴池	澡堂	澡塘	浴場
銀行	錢莊	銀號	儲蓄所	存儲點
代辦點	代理點
照相館	攝影部
雜食店	食雜店	便民店
快餐館	速食店
咖啡館	咖啡廳	咖啡吧	咖啡店
工商行	工行
營業廳	營業室
中國人民銀行	中國銀行	中行
世界銀行	世行
中央銀行	央行
集團公司	集團
非國有企業	私企
實體	實業
學校	校	學	學堂	黌	該校	母校	全校	學府	院所	院校
私塾	學塾	家塾	館	村學	社學	書院	村塾
義學	義塾
高等學校	大學	高校
學院	院
專科學校	專科
附屬中學	附中
高級中學	高中	普高
初級中學	初中
附屬小學	附小
高級小學	高小
初級小學	初小
完全小學	完小	小學	小學校
幼稚園	幼稚園	托兒所	幼兒所
師範學校	師範	師大	師範大學
大專學校	大專院校
職高	職業高中
醫科院	醫學院
大職校	職校	職大
醫院	衛生院	病院	診所	診療所	醫務室	保健室	保健站	衛生所	衛生站	醫務所
產院	婦產科
精神病院	瘋人院
救護所	庇護所
療養院	休養院	休養所	幹休所	康復站
敬老院	養老院	福利院	老人院	托老院
電影院	影院	影戲院	影劇院	電影室
劇院	劇場	戲院	戲園子	歌劇院	戲館子	小劇場
劇團	劇院	班子	班	草台班	戲班	戲班子	馬戲團
文工團	歌舞團	文聯	評劇團	豫劇團
體育場	運動場	操場
舞場	舞廳
文化宮	文化館	俱樂部	遊樂場	遊藝場	文學社	畫報社
博物館	博物院
報社	報館
電臺	無線電臺	轉播台
聯社	聯合社
速度	速	快	快慢	進度
聲速	音速
音強	音勢
地震烈度	烈度
抗張強度	抗拉強度
精密度	精度
高度	高	高矮	高低	長短	長
海拔	高程
深度	深	吃水	深淺	縱深	進深
厚度	厚薄	薄厚
寬度	寬窄	幅度	幅面	開間	肥瘦	寬	幅	大幅度	調幅	幅寬	增幅	漲幅	升幅	步幅	播幅	增長率	步長	寬幅	淨寬	單幅	小幅
個頭	個兒	身材	身長	身量	個子	塊頭
長度	長	尺寸	長短
尺碼	尺寸
縮尺	比例尺
濃度	濃淡	深淺
重量	分量	重	輕重	份額	份量	毛重	千粒重	淨重
負荷	負載	載荷	載重	荷重
音量	響度	高低	輕重
光度	燈光	光
工資分	工分
頻道	頻段	頻率段
聲望度	知名度
溫度	溫	熱度
地溫	土溫
燒	熱	熱度	光熱
燃點	著火點	發火點
距離	間隔	間距	跨距	區間
路程	行程	里程	路途	路	程	總長
規程	回程	歸程
波幅	振幅
數量	數	數目	數碼	數額	額數	多少	多寡	數據
總數	總額	總和
餘數	仂
人數	人頭	人口	人	口	丁	家口	食指	總人口
字數	篇幅
整數	平頭	成數
尾數	尾子	零數	奇
答數	得數
和數	和
差數	差
乘積	積
乘方	乘冪	積數
偶數	雙數
奇數	單數
分數	分
零數	零頭	零兒
函數	因變數
逆函數	反函數
因數	因數
等差級數	算術級數
等比級數	幾何級數
自變數	引數
十進對數	常用對數
無窮大	無限大
無窮小	無限小
方根	根
常量	恒量
當量	化學當量	熱功當量
食量	飯量	胃口
空額	缺額	缺
一	壹	麼	么	單科	單件	單個
二	貳	兩	倆	二元
三	三	仨
四	肆
五	伍
六	陸
七	柒	拐
八	捌
九	玖
十	什	拾
廿	念
百	佰
千	仟
億	垓
零	洞	零蛋
第一	頭	元	首	初	伯	長	冠	魁	正	處女	首先	最先	老大	狀元	首次	初次	首屆	首批	首任	首位	頭版	排頭	正負	首度	頭條	首家
第二	二	次	仲	亞	其次	老二	伯仲	次之
第三	三	叔	老三	其三
第四	四	季
半	一半	半拉	半拉子	半截	半數	參半	攔腰
過半	大半	多半	多數	大多數	左半	半數以上
小半	少數	一點	一些	好幾	或多或少	某些	幾許	幾分
概數	約數
幾	數	若干	些	把	兩	頭	來
內外	上下	左右	光景	前後
多	出頭	冒尖	掛零	有零	開外	有餘	余	強	又	多種
不到	近	奔	上	弱
若干	多少	好多	幾多	幾何	幾	多	多多少少
倍數	倍	倍兒	翻番	公倍數
成數	成
折扣	折頭	折	扣	對折	倒扣
比率	率	比值
概率	幾率	或然率	票房價值
比例	比	對比
正比例	正比
反比例	反比
比重	比例	百分比	百分數	分之
數量單位	標準單位
群	幫	幫子	班	夥	批	股	起	起子	隊	拔	把子
排	進	溜	列	行	趟
串	掛	嘟嚕	梭子	緡
堆	團	墩
疊	遝	摞
叢	束	簇	炷	蔸	蓬
掐	把	把子
綹	縷
捆	葤	卷	各卷
抱	捧	圍
絞	股
擔	挑
身	套	一整套
襲	領	件
對	雙	副
種	樣	類	種種
各	個	員	位	號	各隊	各類	各條	各項
個	只	每支
棟	座	所	幢
層	級	磴
棵	蔸	株
架	台	部	台數
輛	部	這部
家	戶
丘	片	塊	畈
張	紙
匹	頭	腔	峰	條
尾	條
顆	粒	發	丸
幅	幀	軸
艘	只	條
枝	條	杆	挺	根	管	莖
冊	本
帙	部	套	函
首	篇
餐	頓
股	劑	帖	煎	味	料
桌	席
扇	樘	槽
攤	汪
道	條	泓	股	灣	抹
件	碼	起	宗	樁	項	檔子	檔兒
批	票	宗
回合	合
回	章	節	段	章節	條塊	區塊	回目
截	段	段落	段子
派	片	番
線	絲
班	趟	次	件次
客	份	賣
枚	朵
千伏安	千瓦
車皮	專列
次	度	回	道	番	趟	遍	巡	和	水	歷屆
周	圈	匝	遭	轉	來回
陣	陣子	一陣	陣陣
下	記	把	一下
中緯度	經緯度
公尺	米
盎司	英兩
長	漫長	修長	漫漫	修	永	條	久	長達	長長的	長條
細長	狹長	超長
短	短小	短巴巴	短出出	短粗	短撅撅	短短的
高	萬丈	摩天	參天	淩雲	亭亭	危	峨	高聳入雲	乾雲蔽日	最高	高高的	嵩	齊天
修長	頎長	瘦長	細高挑兒	細高	高挑	大個
高聳	突兀	屹立	屹然	兀
高大	魁梧	魁偉	偉岸	巍然	巋然	巍峨	巍巍	崔嵬	傻高	嵬	巍	峻
矮	銼	低	低平	低於	矬	壓低	最低	倭
矮小	短小	小個兒
矮胖	矮墩墩	五短身材
大	巨	宏	巨大	碩大	龐大	宏大	偌大	粗大	高大	碩大無朋	洪大	極大	龐然大物	特大	大幅度	翻天覆地	鞠	碩	龐
寬大	肥大	肥
大型	巨型	重型	特大型
大而無當	重特大	超大	碩大無比
中	中等	半大	中型	適中	不大不小	中小
小	微	細	纖	微小	細小	微細	細微	幽微	纖維	纖毫	纖小	短小	矮小	蠅頭	一丁點兒	小不點兒	微乎其微	不大	最小	芾	小小	很小	小小的
小型	微型	袖珍
廣闊	寬闊	開闊	遼闊	廣大	廣漠	廣	曠	空曠	空闊	空廓	寥寥	蒼茫	荒漠	浩蕩	浩瀚	浩渺	彌漫	茫茫	莽莽	漠漠	恢恢	連天	洪洞	萬頃	無邊	無涯	無垠	無際	無邊無際	漫無邊際	一望無際	漫無止境	深廣	天網恢恢	硝煙彌漫	灝	漫無際涯	無量	一展無垠	浩瀚無垠	空闊無垠	浩然	瀚	渾然無垠	廣袤無際	一望無垠	宏闊	淼	一望無涯	蒼莽	廣闊無垠	曠遠	浩淼	寥廓	氤氳
滔滔	咪咪	洋洋	泱泱	波濤萬頃	煙波浩渺	煙波浩淼
寬敞	寬闊	寬大	寬廣	寬綽	寬舒	寬餘	寬	敞	軒敞	坦蕩	開豁	開闊	開朗	放寬	寬曠	寬心	拓寬	寬寬敞敞	平闊	坦坦蕩蕩	闊大
狹窄	窄	狹	小	陋	瘦	狹小	窄小	褊狹	局促	狹隘	逼仄	湫隘	仄	小心眼兒	隘	偏狹	褊	窄窄	蹙
深	幽	幽深	深邃	窈窕	萬丈	深不可測	深深	深深地	水深	深深的
淺	淺水
厚	厚實	豐厚	厚墩墩	厚厚	厚實實	粗厚	厚厚的
薄	單薄	超薄	薄薄的
扁	扁平
粗	粗大	肥大	粗壯	粗實	粗重	侉	奘	闊	五大三粗	粗墩墩	短粗
細	纖細	細小	纖小	細長	苗條	細弱	巨細	細部	細高	細條條	細細	細細的
胖	肥	肥胖	肥壯	肥碩	肥實	肥乎乎	心寬體胖	胖墩墩	胖乎乎	心寬體胖	肥得魯兒	肥滾滾	肥囊囊	膀闊腰圓	肥厚	腴	胖胖	膘肥肉厚
豐滿	豐盈	豐腴	充盈	豐潤
臃腫	虛胖
大腹便便	腦滿腸肥
瘦	清瘦	消瘦	清臒	瘦小	瘦瘠	乾癟	枯瘦	骨瘦如柴	骨頭架子	瘦幹	瘦骨嶙峋	瘦削	乾瘦	黑瘦	黃皮寡瘦	精瘦
憔悴	枯槁	面黃肌瘦	鳩形鵠面
直	筆直	挺直	垂直	鉛直	直溜	直溜溜	僵直	直挺挺	直統統
曲	曲折	彎	彎曲	彎彎曲曲	曲曲彎彎	彎矩	彎曲形變	鞠
委曲	迂曲	盤曲	蜿蜒	羊腸	逶迤	屹立	轉彎抹角	曲裡拐彎	峰迴路轉
拳曲	蜷曲
九折	九曲回腸
平	平行
挺	筆挺	挺括	挺起
皺	縱	揪	翹	翹棱	皺皺巴巴	皺巴巴
正	端正	周正	平正	方正	方方正正	平頭正臉	板正	端端正正
歪	歪斜	傾斜	偏斜	趄	坡	歪歪扭扭	歪七扭八	七扭八歪	七歪八扭	橫倒豎歪	歪歪斜斜	東倒西歪
規則	平整	平展展	條條框框
參差	參差不齊	橫七豎八
嶙峋	嶙峋	奇形怪狀
尖	尖銳	尖溜溜
禿	鈍
凸	穹隆	陽	拱	鼓鼓囊囊	鼓囊囊	努	凸出	凸顯
石拱	拱券
凹	凹陷	下陷	窪陷	低窪	湫隘	瞘	陰	塌	癟	窪	低凹	圬
平坦	平緩	坦緩	坦	平	平滑	平正	平整	平展	平易	坦蕩	一馬平川	平平整整	坦坦蕩蕩
崎嶇	起伏	此起彼伏	此伏彼起	起伏跌宕	起起伏伏的	起起伏伏	跌宕起伏	漲跌
凹凸不平	高低不平	坑坑窪窪	疙疙瘩瘩	七高八低	七上八下	崎嶇	崎嶇不平	坎坷不平	凹凸
陡峭	陡	陡直	峭拔	壁立	峭	陡陡仄仄
高峻	陡峻	峻峭	連天	崢嶸	嵯峨	巍峨	峻	嶸	崢	峭拔冷峻
方	正方	見方	四方	方方正正	方塊	方框	五方
長方	矩形	矩
圓	渾圓	滾圓	滾瓜溜圓	團團	團	圓溜溜	圓滾滾	圓乎乎	溜圓	圓周	圓圓	圓圓的	圓渾
橢圓	長圓	扁圓	扁圓形
半圓形	弧形	拱形	拱	半圓	圓弧
半月形	彎月形	月牙形
多	許多	好多	這麼些	廣大	浩大	浩繁	無數	眾多	眾	群	叢	博	累累	洋洋	灑灑	重重	那麼些	有的是	成千上萬	胸中無數	好些	很多	居多	袞袞	奐	莘	夥	諸多	廣土眾民	過多	過剩	森	不少	良多	多多	成百上千	上百	為數不少	不在少數	過江之鯽	盈懷充棟	遊人如織	大隊人馬	多多益善
大量	大批	一大批	大宗	巨額	巨	巨大	千萬	萬萬	億萬	千千萬萬	成千成萬	成千累萬	成批	許許多多	數以百計	不可估量	數以百萬計	數以十萬計	數以億計	用之不竭
如林	如雲	成堆	連篇	不乏	滿眼	滿目	林立	滿腹	林林總總	大有文章
濟濟	芸芸	莘莘	大有人在	不乏其人	藏龍臥虎	人才輩出	人才濟濟
一連串	一系列	無窮無盡	浩如煙海	不可勝數	不計其數	不一而足	不勝枚舉	數不勝數	數以萬計	不知凡幾	比比皆是	目不暇接	恒河沙數	更仆難數	車載斗量	汗牛充棟	多如牛毛	洋洋灑灑	密密麻麻	鱗次櫛比	星羅棋佈	滿山遍野	遮天蓋地	鋪天蓋地	滿坑滿谷	雨後春筍	氾濫成災	舉不勝舉	漫山遍野	彌天蓋地	密麻麻	名目繁多	千家萬戶	系列	為數眾多	葦叢	文山會海	聚訟紛紜	羽毛豐滿	多重	多級	層層	多樣	多元
擢髮難數	罄竹難書
少	少數	個別	零星	點滴	稀	寡	鮮	半	兩	片	無幾	有數	有限	一二	區區	半點	一絲	星星	少許	些微	些許	蠅頭	單薄	簡單	寥落	一點兒	這麼點兒	那麼點兒	一丁點兒	三三兩兩	星星點點	一把子	一定量	一星半點	點兒	丁點兒	少於	甚微
寥寥可數	寥寥無幾	寥若晨星	屈指可數	碩果僅存	微乎其微	微不足道	九牛一毛	鳳毛麟角	聊勝於無	所剩無幾	絕少
少量	小量	涓埃	微量	為數不多
絲毫	秋毫	分毫	毫釐	毫髮	錙銖	一絲一毫	亳
繁多	萬端	萬千	什錦	繁	多種多樣	各式各樣	形形色色	五花八門	千頭萬緒	五光十色	森羅萬象	豐富多彩	應有盡有	層出不窮	層見疊出	紛	豐富多采	各樣	各種各樣	莫可指數	繁博	醜態百出	饒有	縟
紛繁	繁雜	紛紜	紛紛	紜紜	紛紛揚揚	繽紛
稀少	希少	希罕	稀有	鮮有	少有	希世	罕見	少見	鮮見	偶發	難得	鐵樹開花	千載難逢	千載一時	百年不遇	十年九不遇	不可多得	稀罕	稀缺	稀世	罕	荒無人煙	難得一見	闊闊的	稀有	萬分之一	千分之一	斑斑	薄薄	層層
單	只	孤	獨	寡	個	單瓣
雙	偶	對	夾	複	儷	駢	對偶	雙料	雙雙	對仗
全部	全體	一切	所有	整個	整整	全副	全份	成套	整套	一體	囫圇	全	整	合	闔	舉	通	普	盡	悉	一	滿	渾	周	遍	漫	上上下下	裡裡外外	百分之百	不折不扣	原原本本	一五一十	佈滿	從頭至尾	總體	任何	萬事	凡事	竭	滿貫	漫天	全勤	通欄	全方位	全套	全總	滿門	俱全	方方面面	盡數	全路
部分	有些	有的	有	局部	片	片段	一部分	一對	一些	組成部分	有點兒
少數	個別
多數	大部分	大多數	絕大多數	大部
密	稠	稠密	濃密	緻密	細密	繁密	密實	密匝匝	密密匝匝	密密層層	層層疊疊	密密叢叢	黑壓壓	森	密密	密佈
疏	稀	稀疏	蕭疏	疏落	疏散	稀稀拉拉	稀稀落落
沖散	打散
茂盛	旺盛	豐茂	盛	茂	豐	紅火	繁茂	蕃茂	莽莽	萋萋	菁菁	蓊鬱	繁蕪	繁榮	茸茸	鬱鬱	蓬	夭	茸	枝繁葉茂	奐	芾	葳	花繁葉茂	毛茸茸	綠綠蔥蔥	蓊蓊鬱鬱
蔥翠	蔥蘢	蔥郁	蘢蔥	蒼鬱	蔥蔥	鬱鬱蔥蔥	鬱鬱蒼蒼	茵茵
茂密	森然	森森	扶疏	蓮蓬
荒蕪	荒廢	荒	廢	草荒	寸草不生	杳無人煙	人煙稀少	蕪	撂荒
肥沃	肥美	肥	沃	膏腴
貧瘠	瘠薄	薄	瘦	瘠	瘦瘠	薄地	貧壤瘠土	磽薄
空	空	空落落	空蕩蕩	光溜溜	空無所有	一無所有	別無長物	空空如也	空空洞洞	家徒四壁	空白	空串	空手	空域	一無所獲
空心	秕	中空
實	實心
滿	滿登登	滿滿當當	滿當當	滿滿
飽滿	飽	飽和
滿座	客滿	座無虛席	滿額	滿員	爆滿	高朋滿座
滿街	滿城風雨
光禿禿	禿	童	濯濯
完整	完全	完好	整體	整	完	圓	渾然一體	完好無缺	完好無恙	完好無損	整機	總體	共同體	完完全全	整整的	一體化
齊全	齊備	完備	全	齊	實足	絲毫不少	兼備	大全	全稱	詳備	萬事俱備
殘缺	欠缺	殘	殘缺不全	半半拉拉	有頭無尾	減頭去尾	掐頭去尾	斬頭去尾	挂一漏萬	殘編斷簡	殘部	不盡
殘破	禿	支離	支離破碎
殘存	殘留	殘餘
零碎	細碎	零星	零落	零散	碎	散	零	零七八碎	七零八碎	七零八落	一鱗半爪	東鱗西爪	雞零狗碎	零打碎敲	零零星星	零敲碎打	碎片	心碎	散裝
破爛	破碎	破損	破敗	破綻	襤褸	麻花	爛	破	敗	敝	百孔千瘡	千瘡百孔	破爛兒	破破爛爛	破相	爛乎乎	破爛不堪
鶉衣百結	捉襟見肘	衣不蔽體	襤褸不堪
冗長	長	長篇大論	洋洋灑灑	沒完沒了	連篇累牘	累牘連篇	拖泥帶水	洋洋萬言
簡短	短小	簡練	精練	凝練	洗練	簡潔	簡要	簡明	簡單	精簡	簡	簡明扼要	要言不煩	言簡意賅	從簡	簡潔明瞭	精短
緊	嚴	緊密	緊身	嚴緊	嚴密	嚴實	緊巴巴	緊繃繃	緊緊	收緊	嚴嚴實實	緊巴
松	泡	糠	暄	蓬	鬆軟	鬆弛	鬆散	稀鬆	平松	蓬鬆	尨茸	弛懈	寬鬆
硬	堅	棒	僵	堅硬	硬棒	硬實	強直	僵硬	硬邦邦	梆硬	繃硬	凍僵	幹梆梆	硬梆梆	硬邦邦的
板	板結	板實
軟	柔	軟和	綿軟	柔軟	柔韌	柔嫩	鬆軟	軟綿綿	軟乎乎	軟塌塌	細軟	心軟	軟軟	柔曼	絨絨的	軟性
爛	酥	爛糊	稀爛	麵糊	面乎乎
脆	鬆脆	酥脆	脆生
牢	固	牢靠	牢固	堅固	強固	結實	扎實	皮實	堅實	確實	瓷實	耐久	耐用	經久耐用	金湯	牢牢	戶樞不蠹	耐穿	凝固	死死	天羅地網	死死地	流水不腐	凝煉
韌	堅韌	柔韌	韌性	艮	韌勁
濃	厚	濃重	濃厚	濃濃的	濃濃
稠	糨	稠乎乎	粘稠
黏	黏糊	膩	糯	油膩膩
稀	薄	談	稀薄	淡薄	稀溜溜	淡淡的
重	沉	沉重	沉沉	沉甸甸	壓秤	厚重	輜重
輕	輕飄	輕飄飄	泰山鴻毛	輕車簡從	輕輕	輕於鴻毛	輕裝	輕輕地	輕輕的	輕度
笨重	粗重	粗笨
輕巧	精巧	靈巧
輕快	輕飄	輕盈	輕巧	輕柔	翩然	翩翩	翩躚
鋒利	利	快	銳	銳利	尖利	飛快	尖銳	削鐵如泥
鈍	不快
生	生澀	夾生	青	半生不熟	青青
熟	熟透	黃	黃熟	爛熟
嫩	鮮嫩	細嫩	柔嫩	鮮嫩嫩	香嫩	白嫩
響	高	響亮	豁亮	洪亮	嘹亮	琅琅	朗朗	高亢	高昂	響噹噹	鏗鏘	鏗然	激越	聲如洪鐘	龍吟虎嘯	轟響	宏亮	亢	朗	脆亮	脆響	怒號	鳴笛
雷鳴	雷動	震耳欲聾	響徹雲霄	響遏行雲	穿雲裂石	瓦釜雷鳴	振聾發聵	如雷似火
輕	細	低	輕柔	低微	細微	細小	悄悄	幽咽	細聲細氣	不絕如縷	輕輕的	悄悄的	細語
尖	尖利	尖銳	尖溜溜
粗	粗重	粗大	粗壯	甕聲甕氣
沙啞	嘶啞	沙
低沉	深沉	悶
悅耳	入耳	順耳	好聽	動聽	受聽	中聽	悠揚	悠悠揚揚	磬	天花亂墜
婉轉	纏綿	柔和	圓潤	抑揚頓挫	娓娓動聽	餘音繞梁	珠圓玉潤	大珠小珠落玉盤	聲如銀鈴	宛轉	悠揚	抑揚	悠悠揚揚
清脆	脆	脆生	清朗
難聽	刺耳	紮耳朵	不堪入耳
亮	明	皓	明亮	亮堂	通亮	光亮	雪亮	鮮亮	敞亮	豁亮	透亮	清亮	明朗	清明	通明	鮮明	光明	透亮	輝煌	明快	金燦燦	亮光光	亮閃閃	亮錚錚	亮堂堂	火光燭天	光芒萬丈	光燦燦	光輝燦爛	心明眼亮	黑亮	爍	熠	亮晃晃	亮亮的	煌	曄	燦	炳	煥	炯	杲	銀亮	煊	鋥亮	灼亮	紅燦燦	燈火輝煌	空明	有光
耀眼	奪目	炫目	刺眼	燦爛	粲然	明晃晃	燦若雲霞	燦若群星	璀璨	群星璀璨	璀璨奪目	耀目	光彩耀目
炯炯	灼灼	灼	炯炯有神	熠熠生輝	熠熠
皎潔	皎皎	皓月當空	月明如鏡	月光如水	朗	秋月當空
光潔	晶瑩	晶亮	明澈	亮晶晶	水汪汪	亮澤	光彩照人
油光	油汪汪	賊亮
熒熒	熹微	濛濛亮	麻麻亮	微亮
暗	陰暗	幽暗	晦暗	昏暗	灰暗	黯淡	暗淡	陰沉	昏沉	昏黃	黯然	慘澹	慘白	灰濛濛	黑糊糊	黑黝黝	天昏地暗	昏天黑地	麻麻黑	森	陰森森	毒花花	灰沉沉
背陰	背光
幽幽	幽然
黑暗	昏黑	黝黑	黢黑	墨黑	漆黑	黑	黑洞洞	黑沉沉	黑咕隆咚	黑燈瞎火	漆黑一團	暗沉沉	黑咕隆冬	昧
清澈	清亮	清明	明淨	明澈	澄澈	澄清	純淨	清澈	澄清	清	洌	清淩淩	澄	瀟	清洌	瀅	清洌洌	河晏水清	清冽
透明	透亮	晶瑩	晶瑩剔透	透剔
渾濁	混濁	渾	濁
清晰	明晰	清	清楚	歷歷	分明	鮮明	一清二楚	黑白分明	旁觀者清	清清楚楚	明明白白	冥	澄	丁是丁	白紙黑字	清麗	不可磨滅
模糊	糊塗	朦朧	莽蒼	迷茫	渺茫	縹緲	隱約	隱隱	微茫	恍惚	依稀	白濛濛	黑糊糊	黑忽忽	黑乎乎	模糊不清	糊裡糊塗	若明若暗	影影綽綽	隱隱約約	隱約可見	霧裡看花	模模糊糊	飄渺	糊裡糊塗	恍恍忽忽	若隱若現	莫明其妙	不明	盲目	蒙朧	渺無音信	幽渺	恍	迷蒙	朦朦	盲用	惺忪
遠	遙	遙遠	遙遙	遼遠	悠遠	迢迢	幽幽	杳渺	千里迢迢	千山萬水	萬水千山	天南海北	遠在天邊	天各一方	天涯海角	十萬八千里	遠遠	邈	幽遠	邈遠	邃遠	不遠千里	迢迢萬里	老遠	遐
偏遠	邊遠
遠端	遠道	長途	遠距離	長距離	中長途
近	在望	近便	咫尺	近在咫尺	近在眼前	近在眉睫	朝發夕至	一山之隔	一水之隔	一衣帶水	一牆之隔
鄰近	鄰	附近	地鄰	緊鄰	鄰縣	鄰座	相鄰	隔壁	比肩而鄰	四鄰八村
短途	短距離	近距離
以近	遠近
早	早日	早早兒	早早	為時過早	為時尚早	先於	先入為主
初	新
遲	晚	深	晏	日上三竿	姍姍來遲	遲到	為時過晚
暮	殘
夜深	夜深人靜	三更半夜	半夜三更
快	速	疾	飛	快速	高速	迅速	神速	迅猛	火速	飛速	全速	迅捷	敏捷	矯捷	便捷	輕捷	迅疾	麻利	快當	飛快	飛躍	長足	靈通	劈手	飛針走線	急若流星	很快	迅	不會兒	快快	霎時	短平快	高效	快捷
如梭	跌進	速成	高效率
疾馳	一溜煙	騰雲駕霧	骨騰肉飛	風馳電掣	追風逐電	一日千里	日行千里
光陰似箭	日月如梭
不脛而走	不翼而飛
急轉直下	一瀉千里	迅雷不及掩耳	稍縱即逝	眼明手快	兵貴神速	迅雷不及掩耳之勢
不假思索	一目十行	一揮而就	一蹴而就
指日可待	計日程功
迅疾	急速	急性	急遽	急劇	急驟	急促	湍急	急	急湍	急湍湍	加急	疾速	節節
慢	緩	徐	款	緩慢	舒緩	款款	徐徐	遲遲	磨蹭	迂緩	遲緩	遲延	遲滯	悠悠	冉冉	慢性	慢慢騰騰	慢悠悠	慢條斯理	蝸行牛步	緩緩	減緩	慢慢吞吞	慢慢悠悠	慢騰騰	慢吞吞	暫緩	放緩	磨磨蹭蹭
頻率	效率
長久	久長	悠久	許久	好久	良久	久長	綿長	綿綿	漫長	漫漫	久遠	長遠	遙遠	悠遠	悠長	長期	老	永	馬拉松	久而久之	長此以往	曠日持久	遙遙無期	天荒地老	地老天荒	天長日久	日久天長	天長地久	地久天長	時久天長	久	久久	經久	經久不衰	多時	由來已久	一勞永逸	代遠年湮	千古不滅	青山常在	曆演不衰	歷久不衰	年代久遠
多年	有年	積年	連年	成年累月	經年累月	積年累月	長年累月	窮年累月	累月經年	年久月深	年深月久	整年累月	常年累月	從小到大
整年	通年	終年	常年	成年	長年	一年到頭	終歲
整天	終天	終日	成天	成日	一天到晚	從早到晚	無日無夜	整天价	全日
整夜	通夜	終夜	徹夜	通宵	通宵達旦
日日夜夜	日以繼夜	沒日沒夜
半晌	半天	有會子	有日子	常設
永遠	永世	永恆	永久	恒久	千古	萬古	萬年	萬世	萬代	世代	永	千秋萬代	子孫萬代	世世代代	祖祖輩輩	子子孫孫	萬古千秋	億萬斯年	永生永世	終古不息	不可磨滅
短促	短暫	急促	局促	在望	短	淺	為期不遠	指日可待	五日京兆	一朝一夕	墨蹟未乾	屍骨未寒	曾幾何時	兔子尾巴長不了	不久	短短	短命	短跑	即期	一朝	好景不長
一會兒	會兒	一忽兒	一陣子	不一會	片刻	一刻	頃刻	漏刻	說話	片時	少時	少刻	少頃	俄頃	頃	須臾	巡	一時半刻	稍頃	時隔不久
一眨眼	一轉眼	一晃	一刹那	刹那間	霎時間	一霎	一瞬	轉瞬間	瞬間	倏地	倏忽	倏	瞬	瞬息間	轉眼間	轉手	轉臉	一下子	俯仰之間	彈指之間	轉	分秒	瞬間	瞬息	一念之差	一時間	刹那	一霎時	一下	忽而	時而	刹時	轉瞬	轉眼	霎時	瞬即	暫態	頃刻間	下子	一瞬間	一晃兒
暫時	臨時	權時	暫	少	小	暫行	短時	暫時性	臨時性
冷	寒冷	冰冷	冰涼	凍	寒	冷冰冰	陰冷	僵冷
清寒	冷颼颼	冷絲絲	冷若冰霜	冷溲溲
苦寒	嚴寒	高寒	冷峭	寒峭	刺骨	慘烈	乾冷	淒清	寒氣襲人	天寒地凍	滴水成冰	冰天雪地	冰凍三尺	凜凜	凜冽	春寒	料峭	春寒料峭	奇寒	寒風料峭	寒意料峭
寒濕	發潮
饑寒	饑寒交加
熱	熱火	熱和	熱乎	熱乎乎	熱烘烘	熱騰騰	熱滾滾	熱哄哄	熱力	熱呼呼
燙	滾燙	滾熱	灼熱
炎熱	炎炎	暑熱	熾熱	火熱	酷熱	酷暑	燥熱	薰蒸	炎	署	火辣辣	熱辣辣	驕陽似火	汗流浹背	汗如雨下	鑠石流金	流金鑠石	暑	烈日當空	溽暑	燠	熾
涼	涼快	風涼	陰涼	蔭涼	涼絲絲	涼颼颼	沁人心脾	涼蘇蘇	涼溲溲	清涼	秋涼	涼意
暖	溫	暖和	和暖	和煦	溫煦	晴和	和暢	融融	溫暖	溫和	溫暾	暖烘烘	暖洋洋	風和日暖	風和日麗	採暖	暖融融	煦	暖乎乎	溫軟	溫暖如春
冷熱	寒熱
涼爽	爽	爽朗	沁人心脾	滑爽	沁入心扉
悶氣	悶熱	悶	鬱熱	不透氣
乾燥	幹	燥	乾澀
乾枯	焦枯	枯槁	乾巴	乾巴巴
乾涸	乾旱	旱	枯竭
潮濕	濡濕	濕潤	回潮	潮乎乎	潮	潮呼呼	汗浸浸	溫濕	濕寒	潮潤	溽熱
濕	濕淋淋	溻	濕透	潤濕	濕乎乎	陰濕	濕漉漉
滋潤	潤澤
新	簇新	嶄新	全新	別樹一幟	獨創性
新式	新穎	新型	時新	摩登	時髦	行時	入時	時興	流行	風行	風靡	時	行	新星	最新	面貌一新	流行性
時鮮	應時	應景
新鮮	鮮	清新	清馨	鮮味	生鮮
舊	陳舊	陳	老	老掉牙	老牛破車	破舊	年久失修
老式	過時	不興	背時	老一套	不合時宜
古老	古	古舊	老古董	蒼古
古樸	古拙	古雅	古色古香
美麗	漂亮	好看	受看	中看	入眼	順眼	悅目	美觀	華美	優美	美妙	美	麗	菲菲	美美	幽美	泛美	姣好
秀美	秀氣	清秀	靈秀	挺秀	娟秀	韶秀	秀麗	明麗	俏麗	俏	奇秀	脆麗	娟	綺	秀色	虯曲挺秀	鐘靈毓秀	水靈靈
華麗	富麗	壯麗	綺麗	瑰麗	豔麗	花枝招展	亮麗	壯偉
鮮豔	濃豔	妖豔	明媚	秀媚	嫵媚	妍	豔	美豔
妖豔	妖冶	妖媚	妖嬈
嬌	嬌媚	柔媚	嬌嬈	嬌豔	嬌滴滴	千嬌百媚	柔情綽態	嬌豔欲滴
絢麗	絢爛	爛漫	燦爛	如花似錦	光彩奪目	鮮豔奪目	萬紫千紅	姹紫嫣紅	花團錦簇	琳琅滿目	美不勝收	多姿多彩	絢	繁花似錦	分外奪目	光燦奪目	燦爛奪目	絢麗奪目	燦若雲霞	燦若星河	光芒四射	燦	多姿
錦繡	入畫	旖旎	山明水秀	風景如畫	花香鳥語	山青水秀	華章錦繡
美貌	標緻	體面	上相	柔美	冶容	秀雅	曼妙	綽約	嬋娟	娟娟	窈窕	絕色	眉清目秀	堂堂正正	一表人才	明眸皓齒	冰肌玉骨	花容玉貌	秀外慧中	閉月羞花	沉魚落雁	國色天香	天香國色	天姿國色	傾國傾城	佳妙無雙	傾城傾國	絕世無匹	姣妍	西裝革履	陽剛之美	楚楚靜立	眉清目朗	楚楚動人	風華絕代	美若天仙	如花似玉	嫣然	婷	婷婷
俊美	俊秀	俊	俏	俊俏	俏皮	英俊	堂堂
翩翩	嫋娜	婀娜	娉婷	亭亭	嫋嫋婷婷	儀態萬方	亭亭玉立	綽約多姿
醜陋	難看	寒磣	猥瑣	醜	陋	其貌不揚	面目可憎	齜牙咧嘴	賊眉鼠眼	獐頭鼠目	見不得人	猥	人老珠黃
雅致	雅觀	文雅	清雅	淡雅	古雅	雅	大雅	幽雅	優雅	典雅無華
洋氣	洋	文明	洋裡洋氣
土氣	土	土裡土氣
豪華	華	華麗	華貴	堂皇	富麗	富麗堂皇	畫棟雕樑	雕欄玉砌	美輪美奐	冠冕堂皇	金碧輝煌	蓬蓽增輝	堂堂皇皇	珠光寶氣	雍容華貴
奢華	浮華	闊氣	闊綽	闊
鋪張	排場	鋪排	講排場
樸素	純樸	簡樸	質樸	樸質	艱苦樸素	樸	樸實無華	質樸無華	無華	醇朴	拙樸	清純
璞玉渾金	渾金璞玉	歸真返璞
簡陋	陋	鄙陋	因陋就簡	破瓦寒窯	低質
光滑	光	滑	光溜	光溜溜	滑溜	滑膩	光潤	光潔	滑潤	溜光	細膩	細潤	光乎乎	溜滑	油亮
毛糙	粗糙	毛	糙	麻	毛乎乎
精巧	細巧	工巧	纖巧	小巧	奇巧	精緻	工致	精細	工細	細密	精密	精美	精妙	秀氣	玲瓏	細	精	小巧玲瓏	玲瓏剔透	巧奪天工	鬼斧神工	神工鬼斧	嬌小	嬌小玲瓏	精雕細鏤	精製	水磨工夫	迷你	精工細作
講究	考究
粗糙	毛糙	粗陋	粗劣	粗疏	粗	糙	粗笨
人造	人工	人為	事在人為
自動	機動	電動	機關	半自動	從動	活動	自行	全自動	鍵鈕	自發性
雄	公	牧	叫	兒	騷	牡
男	男性	乾	陽
雌	母	牝	草
女	女性	坤	陰
年老	老	上歲數	上年紀	高大	蒼老	衰老	年高	年邁	老邁	高邁	白頭	皓首	大年	老大	老朽	朽邁	老態龍鍾	年事已高	鶴髮雞皮	雞皮鶴髮	行將就木	大齡	七老八十	早衰	老弱病殘	年邁體弱	老態	古稀之年	年逾古稀
垂暮	垂垂老矣	廉頗老矣
長壽	高夀	長年	壽比南山	萬壽無疆	長命百歲	長生不老	龜鶴遐齡	龜鶴延年	益壽延年	延年	萬古常青
年輕	後生	青春	少壯	正當年	血氣方剛	年輕氣盛	年青	青春年少	身強力壯	風華正茂	老大不小	常青	年少	少年心
幼小	幼稚	幼	稚	弱	雛	子	仔	乳	嫩	口輕	粉嫩	幼雛	幼駒	雞雛	低幼	毛頭
健康	康健	強健	健全	健旺	健壯	壯健	結實	強壯	精壯	壯實	硬實	敦實	茁壯	茁實	皮實	硬朗	矯健	健	狀	身強體壯	虎背熊腰	虎頭虎腦	銅筋鐵骨	年富力強	膀大腰圓	膘肥體壯	年輕力壯	身強力壯	康泰	健朗	健碩	身心健康	佶
鶴髮童顏	老當益壯	不減當年	童顏鶴髮	寶刀不老
孱弱	衰弱	瘦弱	單弱	文弱	虛弱	纖弱	軟弱	柔弱	單薄	嬌嫩	弱小	孱	弱	虛	弱不禁風	氣虛	弱者	嬌嫩嫩	嬌柔	矯	體弱	年邁體弱	神經衰弱
無力	綿軟	酥軟	癱軟	軟綿綿	手無縛雞之力	軟弱無力
病懨懨	懨懨	病病歪歪	面黃肌瘦	心力交瘁	步履維艱	步履艱難	未老先衰	病歪歪	病殃殃	要死不活	體弱多病
紅	赤	朱	丹	茜	緋	彤	絳	通紅	鮮紅	血紅	火紅	朱紅	赤紅	猩紅	殷紅	潮紅	嫣紅	紅潤	紅彤彤	紅通通	紅撲撲	紅豔豔	紅不棱登	紅光光
淡紅	淺紅
粉紅	桃紅	妃色	粉色	桃色	粉乎乎	粉撲撲	肉色
大紅	緋紅	品紅
深紅	暗紅
黃	蠟黃	蒼黃	昏黃	焦黃	枯黃	黃燦燦	黃澄澄	金煌煌	棕黃	發黃
淡黃	牙色	淺黃	嫩黃	鵝黃
米黃	米色
杏黃	橙黃	橙色
金黃	金色
土黃	藤黃
藍	蔚藍	天藍	碧藍	寶藍	藍盈盈	藍晶晶	蔚
淡藍	蔥白	月白	品月
深藍	湛藍	靛藍	靛	藍靛	靛青
藏藍	品藍
藏青	海軍藍	海昌藍	瓦藍
青	蒼	青色	青青	粉代萬年青
淡青	蛋青	鴨蛋青	玉色
蟹青	鐵青
蒼蒼	黛色
綠	碧	翠	碧綠	青綠	青翠	青蔥	蒼翠	翠綠	綠油油	綠茸茸	碧油油	翠綠色	綠茵茵	綠瑩瑩	鋪錦疊翠	滴翠	青翠欲滴	疊翠
嫩綠	淡綠	淺綠	翠綠	蔥綠	水綠	湖綠	湖色	蘋果綠	淡青色
深綠	墨綠	暗綠	黛綠	墨綠色
紫	紺青	紫色
雪青	青蓮色	藕荷	淡紫
赭	紅褐色	棕色	醬色	赭色
淺棕	駝色	咖啡色
褐	栗色	茶褐色	茶色	褐色
深褐色	古銅色
白	粉	霜	銀	雪	素	縞	皓	皚皚	潔白	雪白	粉白	乳白	白淨	皎潔	凝脂	白花花	白晃晃	白茫茫	白不呲咧	白皚皚	白乎乎	白淨淨	細白	嫩白	顥
蒼白	慘白	煞白	刷白	死灰
花白	斑白	灰白	蒼蒼	白蒼蒼	白髮蒼蒼
灰	灰溜溜	灰不溜秋	灰色
深灰	暗灰	深灰色
黑	青	烏	皂	墨	緇	黔	墨黑	漆黑	黢黑	烏黑	烏亮	黝黑	焦黑	黧黑	黑油油	黑黝黝	黑黢黢	黑漆漆	黑糊糊	烏油油	烏溜溜	黑不溜秋	濃黑	油黑	黧	發黑	黢	黑滔滔
深	濃	大	暗	老	深深的
淡	嫩	淺
鮮豔	花哨	花裡胡梢	花裡胡哨	爭豔	明豔	發花
五彩	彩色	花	彩	印花	雜色	五顏六色	五色繽紛	花花綠綠	花團錦簇	萬紫千紅	姹紫嫣紅	大紅大綠	花紅柳綠	多彩	多姿多彩	五彩紛呈	五彩繽紛	絢麗多彩	絢麗多姿	異彩	嫣	萬紫千紅春滿園	斑塊	色彩繽紛	異彩紛呈	色彩紛呈	五彩斑斕	多姿
斑斕	光怪陸離	斑	色彩斑斕	耀斑
斑駁	斑駁陸離	花花搭搭
素淨	素	淡	素淡	清淡	素雅	淡雅	樸素	素樸	素性	樸素無華
香	噴香	香噴噴	芳香	芬芳	芳菲	菲菲	清香	馨香	異香	香澤	芳澤	馥鬱	香氣撲鼻	甜香	飄香	香撲撲	香氣	香味	香馥馥	馥馥	幽香	果香	餘香	醇芳	酒香	花香	香醇	香嫩	濃香	馥	馨
濃郁	鬱鬱
臭	葷	臭烘烘	臭氣熏天	臭乎乎	臭氣	臭味	惡臭	五葷
狐臭	狐臊
腥	腥氣	土腥氣	血腥	腥味兒
膻	腥膻
臊	臊氣	腥臊	乳臭
甜	甘	蜜	糖	甘甜	香甜	甜美	甘美	甜絲絲	甜津津	甘之如飴	甜味	甜滋滋	糖蜜	甜甜的
酸	酸溜溜	酸度	發酸
苦	苦口	甘苦	苦味	苦英英
澀	苦澀
辣	辛	辛辣	麻辣	辣絲絲	辣乎乎	辣味
鹹	鹹津津	口重	死鹹	鹹乎乎	鹹味
淡	薄	淡薄	口輕	清淡	白不呲咧	淡巴巴
可口	美味	入味	是味兒	夠味兒	好吃	適口	順口	爽口	水靈	鮮美	鮮	香	美味可口
難吃	倒胃口
醇厚	濃厚	純	厚	濃	釅	沖	濃郁	醇	醇香	濃烈
醇和	清醇
油膩	膩	油汪汪	油光光	油乎乎	雋
清淡	寡	清湯寡水
真實	實	真	誠	誠實	忠實	實際	實在	實打實	篤實	真正	真性	真格的	真心實意	誠心誠意	實事求是	真人真事	真格	真真	動真格的	一是一	真實性
十足	十分	地道	道地	赤	貨真價實	原汁原味	地地道道	真金不怕火煉
名副其實	有名有實	名不虛傳	名下無虛	真名實姓
虛假	虛	假	偽	贗	虛偽	冒牌	模擬	攙假	假冒偽劣
名義	掛名	應名兒
假想	假設	虛設	設	虛設	子虛	子虛烏有	幻
有名無實	名過其實	名不副實	名存實亡	虛有其表	徒有虛名	言過其實	外面兒光	南箕北斗	掛羊頭賣狗肉	假門假事	假眉三道	形同虛設	名難副實	其實難副	名不符實
言不由衷	心口不一	言行不一	表裡不一	葉公好龍	假大空	好高鶩遠
外強中乾	羊質虎皮
確實	實	確	確鑿	鑿鑿	無疑	的確	的	確切	真切	逼真	活生生	翔實	可靠	靠得住	有據	耳聞目睹	有目共睹	有憑有據	有案可稽	千真萬確	無可置疑	毋庸置疑	不容置疑	信而有征	鐵案如山	實地	實實在在	屬實	如實	鐵證如山	真確	真真切切	無可辯駁	無可爭議	確確實實	毋庸諱言	毋庸置言	活脫	活脫脫
虛妄	無稽	荒誕	誇誕	荒誕不經	超現實	虛玄
影響	靠不住	莫須有	想當然	無憑無據
捕風捉影	鏡花水月	水中撈月	空中樓閣	海市蜃樓	望風捕影	聽風是雨
渺茫	渺	杳
逼真	亂真	傳神	神似	逼肖	惟妙惟肖	活龍活現	繪聲繪影	繪聲繪色	栩栩如生	躍然紙上	呼之欲出	有鼻子有眼兒	以假亂真	繪影繪色	活靈活現	煞有介事	無差別	活脫	形神妙肖	活脫脫
疑似	似是而非	似真似假
失真	走樣	畸變	畫虎類狗	走形	畸
好	優	精	良	帥	佳	嶄	美	妙	良好	大好	優良	精良	優秀	優異	精彩	出色	絕妙	漂亮	精美	美好	完美	美妙	精粹	精練	優質	上好	上上	理想	可以	地道	不含糊	了不起	呱呱叫	頂呱呱	可觀	不錯	夠味兒	要得	盡如人意	完美無缺	盡善盡美	十全十美	白璧無瑕	妙不可言	名不虛傳	有目共賞	有口皆碑	口碑載道	膾炙人口	交口稱譽	好生生	好好	拔尖	說得著	得天獨厚	過得硬	完好無損	有滋有味	兩全其美	佳績	出彩	上佳	甚佳	名特新優精	名特優新	名特優	醇美
高超	高強	高明	高妙	神妙	巧妙	精彩紛呈	精美絕倫	精彩絕倫	搶眼	俱佳	全優	無瑕	都行
精湛	深湛	精深	深邃	精闢	透闢	精湛不磨	博大精深
到家	過硬	高	深	強	巧	精	神	完	全	聖	硬	棒	通天	鬼斧神工	巧奪天工	出神入化	曲盡其妙	無出其右	驕人	超凡	獨領風騷
瑰瑋	瑰麗	鬱鬱	繁麗	諧美	妙曼	漂漂亮亮	嬌美
錦心繡口	文不加點	一字千金	生花妙筆	擲地有聲	百讀不厭	洛陽紙貴
龍飛鳳舞	好戲連台
字正腔圓	餘音繞梁	地地道道
浮豔	豔
優越	優勝	優惠	優厚	優渥	優勝劣敗	優於	優惠待遇	優化	有過之而無不及	特惠	價廉質優	從優
三好	品學兼優
壞	差	次	軟	淺	破	糟	鬼	賴	孬	潮	不好	不良	不行	不妙	不善	差勁	稀鬆	糟糕	蹩腳	塗鴉	窳劣	二五眼	差點兒	驢鳴狗吠	次等	欠佳	不成	莠	二流	次於
不成話	要不得	一團糟	不足取	一無可取	一塌糊塗	看不上眼	不堪設想	不像話
惡劣	低劣	粗劣	卑劣	拙劣	猥陋	卑下	劣	惡	歹	劣質	偽劣	惡性	歹心	假劣
傑出	突出	出眾	特異	卓著	卓越	卓絕	超絕	超群	超人	獨立	卓然	拔尖兒	冒尖兒	數得著	數一數二	出人頭地	出類拔萃	頭角崢嶸	超塵拔俗	超群絕倫	鶴立雞群	獨佔鰲頭	首屈一指	名列前茅	至高無上	天下第一	登峰造極	百裡挑一	超凡入聖	榜首	數不著	加人一等	人才出眾	堪稱一絕	一流	第一流	名列榜首	天下無雙	獨秀一枝	一枝獨秀	一花獨放	典型
不凡	非凡	別致	了不起	不簡單	不同凡響	高視闊步	匪夷所思	卓爾不群	非同一般	出口不凡	氣度不凡	不拘一格	身手不凡	驚世駭俗	超能	超自然	超導
空前	劃時代	破天荒	史無前例	前無古人	前所未有	空前絕後	亙古未有	聞所未聞	見所未見	無先例	破格	前所未見
蓋世	無雙	無比	絕代	曠世	絕倫	獨步	蓋世無雙	獨一無二	絕無僅有	無可比擬	舉世無雙	惟一	絕世
異常	非常	異樣	特別	特異	獨特	特殊	特出	突出	出奇	奇異	奇特	特	殊	奇	異	新鮮	出格	獨出心裁	異乎尋常	與眾不同	特有	特種	例外	破例	新異	奇麗	超常規	非常規	不同尋常	非同尋常	非正規	離譜兒
奇崛	獨到	不落窠臼	獨樹一幟	獨具匠心	別具匠心	匠心獨運	獨闢蹊徑	別開生面	別具一格	別有風味	別出心裁	獨具特色	自成一家	自成一體	獨具一格	匠心獨具	異軍突起	各具特色	特色牌
特定	一定
專門	專
唯一	絕無僅有	唯
普通	一般	平常	通常	尋常	便	日常	慣常	家常	常備	等閒	平凡	平淡無奇	司空見慣	習以為常	不足為奇	數見不鮮	一般性	不足為怪	常見	屢見不鮮	累見不鮮	平平常常	普普通通	一般而言	一般說來	萬般
合格	夠格	及格	過關	過得去	沾邊	馬馬虎虎	通關
像樣	不錯	可以	可	不賴	不離兒	差不離	差強人意	看得過兒	沾邊兒
瑕不掩瑜	大醇小疵	無可厚非
上等	上品	上流	上色	上等	上乘	上	優等	優質	甲	上檔次
高等	高級	高檔	尖端	高等級
頭等	頭號	一品	甲級	甲等	一等	一流	頂級	第一流	世界級	五星級
超等	超級	特等	特級	極品	上上	最佳	至上	頂尖	頂尖級
中等	中檔	中級	中流	中游	中路	中	中間	當中	中不溜兒	高中級	高中檔	中高檔二檔
平平	平常	平庸	尋常	中常	平凡	凡	瑕瑜互見	平淡無奇	不怎麼樣	不過如此	不過爾爾
下等	劣等	下品	低等	低檔	低級	起碼	等外	等而下之	中低檔	中下	丙	初級
困難	艱難	繁難	萬難	疑難	難	難於	為難	難人	作難	討厭	棘手	纏手	扎手	辣手	吃力	費力	費勁	費事	費時	費難	費手腳	繞脖子	傷腦筋	談何容易	來之不易	千難萬難	難上加難	難於登天	寸步難行	積重難返	海底撈針	大海撈針	吃勁	煩難	患難	急難	費工	難辦	難找	犯難	老大難	費工夫	舉步維艱	創業維艱	萬事開頭難	高難	沒法子	別無選擇
艱巨	繁重	吃重	重	千斤	任重道遠	疑難重症	一木難支
艱險	險	艱難險阻	荊棘載途	艱	千難萬險
容易	簡易	輕易	便當	易於	易	好	易如反掌	輕而易舉	俯拾皆是	信手拈來	唾手可得	垂手而得	探囊取物	甕中之鼈	手到擒拿	一揮而就	一蹴而就	一拍即合	迎刃而解	不費吹灰之力	甕中捉鼈	手到擒來	好找	俯拾即是	不難
深奧	深邃	高深	淵深	艱深	精深	精微	古奧	簡古	奧秘	奧博	深	微言大義	曲高和寡	賾
玄妙	奧妙	微妙	神妙	神秘	玄乎	玄	玄之又玄	神妙莫測	莫測高深	高深莫測	玄奧	神秘兮兮
費解	百思不解
淺近	淺顯	淺易	粗淺	淺	通俗	平易	易懂	深入淺出	老嫗能解	初步	達意
工整	工穩	工	整齊	齊整	工工整整	齊刷刷
通順	通暢	通	流暢	暢達	明暢	曉暢	流利	明快	順口	上口	順理成章	文從字順	琅琅上口	珠圓玉潤	朗朗上口
晦澀	生澀	艱澀	澀	生硬	彆扭	拗口	繞嘴	彆彆扭扭	隱晦
實際	現實	切實	求實	具體	言之有物	有血有肉	現實性	切切實實	切實可行	具象
實至名歸	名符其實
空洞	空虛	虛空	空疏	虛無	懸空	架空	空虛	泛	空泛	膚淺	浮泛	泛泛	空幻	虛幻	迂闊	抽象	概念化	虛飃飃	虛無飄渺	不著邊際	華而不實	紙上談兵	言之無物	空空如也	膚泛	乾癟癟	實而不華	虛無縹緲	空洞無物	無意義	失之空洞
全面	全盤	通盤	周全	周到	周至	周	到	圓	到家	兩全	雙全	十全	萬全	健全	完善	完美	完滿	圓滿	一攬子	面面俱到	統籌兼顧	具體而微	應有盡有	包羅萬象	森羅萬象	無所不包	無微不至	一應俱全	宏觀	尺幅千里	兩手	百科
周密	嚴密	謹嚴	嚴謹	無懈可擊	無隙可乘	天衣無縫	滴水不漏	多角度	多管齊下
片面	管窺	挂一漏萬	一鱗半爪	東鱗西爪	斷章取義	瞎子摸象	管窺所及	管中窺豹	窺豹一斑	坐井觀天	畸輕畸重	斷章取義	一面之詞	以偏概全	盲人摸象	單邊
正確	對	是	然	不錯	無誤	對頭	得法	科學	不利	不易	無可非議	無可指責	無可爭辯	無可置疑	毋庸置疑	顛撲不破	頭頭是道	天經地義	放之四海而皆準	正確性	是的	沒錯	無可挑剔	毋庸置言
準確	准	精確	確切	標準	規範	純正	純粹	可靠	靠得住	毫釐不爽	準確無誤	準兒	高精度
箭不虛發	有的放矢	百發百中	百步穿楊	彈無虛發	百無一失	萬無一失	十拿九穩	穩拿把攥
中肯	一語破的	一語道破	一針見血	言必有中	正中要害	識破天機	一語破的
錯誤	錯	誤	左	失實	不當	不對	荒唐	謬誤	悖謬	荒謬	大謬不然	錯誤百出	大錯特錯	一無是處	百無一失	破綻百出	漏洞百出	張冠李戴	似是而非	背謬	繆	錯謬
不足為憑	不足為訓	靠不住	狗屁	盲目	脫誤
筆誤	誤字
合理	有理	在理	像話	靠邊	客觀	成立	站住	站得住	說得過去	入情入理	合情合理	理所當然	情理之中	合理性	合理合法	合情	不無道理	客體
名正言順	理直氣壯	義正詞嚴	振振有詞	言之成理	順理成章	天經地義	言之有理
無理	理虧	理屈	輸理	勉強	主觀	不科學	不合理	不合情理	說不過去	理屈詞窮	師出無名	不攻自破	平白無故	無緣無故	豈有此理	莫名其妙	狗屁不通	無由
生硬	勉強	硬	強	生拉硬拽	生搬硬套	生吞活剝
牽強	鑿空	牽強附會	穿鑿附會	主觀主義
勉強	將就	湊合	對付	結結巴巴	勉為其難	削足適履	勉勉強強	湊和
固定	恒定	永恆	鐵定	一定	穩定	穩	恒	一貫	原則性	固化	定點	定位	錨固	定勢	穩住
不變	靜止	一成不變	原封不動	雷打不動	板上釘釘	不二價	劃一不二	一如既往	一仍舊貫	依然如故	依然故我	以不變應萬變	有序	言無二價	平平穩穩	穩步	平穩	數年如一	一動不動	文風不動
改頭換面	換湯不換藥	萬變不離其宗	定型	千古不變	居高不下
靈活	活	活動	活絡	機動	變通	迴旋	權益	從權	權變	靈活機動	活字	活用	權宜	因地制宜	活潑潑
生動	瀟灑	飄灑	活潑	活躍	活	栩栩如生	繪聲繪色	繪影繪聲	繪聲繪影	有聲有色	聲情並茂	有血有肉	令人神往	窮形盡相	娓娓動聽	頰上添毫	呼之欲出	躍然紙上	聲淚俱下	情真詞切	鮮活	圖文並茂
平板	凝滯	呆滯	板滯	生硬	機械	拘泥	拘板	乾巴巴	平鋪直敘	僵滯	鬱滯
猛烈	劇烈	強烈	酷烈	激烈	熾烈	熱烈	利害	淩厲	激切	急劇	兇猛	狂暴	烈性	霸道	可以	翻天	熊熊	騰騰	洶洶	火熾	急	猛	凶	劇	烈	驕	沖	重	盛	毒	暴	狂	慘	銳	怒	狠	痛	霸氣	火爆	烈烈
致命	沉重	殊死	決死	浴血
無情	毫不留情	水火無情
大張旗鼓	雷厲風行	雷霆萬鈞	轟轟烈烈	如火如荼	風起雲湧	叱吒風雲	暴風驟雨	急風暴雨	天崩地裂	飛砂走石	天翻地覆	地覆天翻	天旋地轉	震天動地	移山倒海	泰山壓頂	勢如破竹	一往無前	勢不可當	銳不可當	風捲殘雲	摧枯拉朽	劈頭蓋臉	泰山壓卵	來勢洶洶	氣勢洶洶	勢不可擋	劈天蓋地	撼天動地	大肆	隆重
尖銳	尖利	犀利	銳利	鋒利	精悍	辛辣	尖刻	尖	舌劍唇槍	唇槍舌劍	尖酸刻薄	咄咄逼人	狠狠
過激	偏激
柔和	平和	溫和	順和	中和	和婉	輕柔	溫柔	優柔	溫情	和緩	平緩	和平	軟和	軟	文	緩	婉	和	溫文爾雅	和風細雨	中庸	低緩	溫婉	溫軟
深刻	深入	深切	尖銳	刻骨	透徹	透闢	深透	中肯	透	淪肌浹髓	刻骨銘心	銘心刻骨	銘肌鏤骨	刻肌刻骨	入木三分	力透紙背	鞭辟入裡	一針見血	一語道破	一語破的	談言微中	深深	深深的	遞進
高度	莫大	驚人	可觀	沖天	萬丈	入骨	徹骨
深遠	遠大	深長	雋永	幽婉	深	有意思	語重心長	微言大義	發人深省	耐人尋味	其味無窮	回味無窮	源遠流長	意味深長	引人深思	發人深省	耐人玩味	覃	甚篤	意猶未盡
深厚	深切	深刻	深湛	濃厚	深	厚	濃	天高地厚	山高水長	地久天長
恩同再造	恩重如山	再生父母
深沉	沉沉	透	深	沉	熟	酣	香	甜	香甜	府城	侯門如海
淡薄	淡漠	淡淡	淡	淺	淡化
膚淺	浮淺	浮泛	泛泛	皮毛	皮相	淺	蜻蜓點水	輕描淡寫	走馬看花	浮光掠影	淺嘗輒止	只鱗片爪
輕微	微薄	菲薄	細微	微小	細小	分寸	輕	薄	一線
細膩	細緻	入微	絲絲入扣	勻細
粗疏	粗線條	粗略	粗劣
穩固	牢固	堅固	鞏固	堅實	結實	深厚	根深蒂固	深根固蒂	堅不可摧	堅如磐石	穩如泰山	固若金湯	金城湯池	牢不可破	穩步	堅牢	壁壘森嚴	鋼鐵長城	銅牆鐵壁	鐵打江山	不衰	長盛不衰
強大	強硬	強勁	強	勁	雄	精	精銳	無敵	有力	強有力	兵強馬壯	所向無敵	所向披靡	一往無前	無往不勝	無堅不摧	攻無不克	戰無不勝	泰山壓頂	摧枯拉朽	降龍伏虎	兵不血刃	投鞭斷流	人多勢眾	切實有力	雄強	船堅炮利	強壓
強盛	富強	國富民強	繁榮富強	國富民安	民富國強	富國強兵
弱小	軟弱	薄弱	虛弱	單弱	衰弱	微弱	貧弱	柔弱	衰微	弱	軟	單薄	勢單力薄	不堪一擊	一觸即潰	赤手空拳	手無寸鐵	立足未穩	一虎勢單	身單力薄
偉大	偉	鴻	弘	丕	壯	高大	宏大	遠大	巨大	宏偉	英雄	光輝	皇皇	赫赫	了不起	驚天動地	頂天立地	震古鑠今	補天浴日	光前裕後	氣勢磅礴	偉人	壯烈	廣遠	奇偉	恢
渺小	藐小	不起眼	看不上眼	不足道	微不足道	不在話下	不值一提	不屑一顧	不足掛齒	無足輕重	一文不值	一錢不值	滄海一粟	太倉一粟	九牛一毛
威武	威嚴	威風	赳赳	虎彪彪	堂堂	英武	英姿颯爽	英姿煥發	英姿勃勃	威風凜凜	八面威風	虎背熊腰	虎虎有生氣	氣概不凡	叱吒風雲	龍騰虎躍	龍驤虎步	一呼百諾	氣昂昂	虎虎生氣	身高馬大	人高馬大	虎虎生威
雄壯	雄偉	宏偉	巍然	澎湃	壯闊	雄勁	粗豪	豪邁	滾滾	堂堂	磅礴	千軍萬馬	萬馬奔騰	聲勢浩大	洶湧澎湃	波湧濤起	波瀾壯闊	浩浩蕩蕩	氣象萬千	氣衝霄漢	氣貫長虹	氣壯山河	氣吞山河	轟轟烈烈	豪壯	壯美	倒海翻江	排山倒海	飛流直下三千尺	蔚為壯觀	壯偉	萬向	盛況空前
居高臨下	高屋建瓴	蔚為大觀	大氣磅礴	氣勢磅礴	大觀	洋洋大觀
險要	險阻	險惡	險峻	關隘	虎踞龍盤	龍蟠虎踞	洶湧	激流洶湧	虎踞龍蟠
雄健	穩健	矯健	剛健	剛勁	蒼勁	遒勁	蒼勁	雄渾	渾厚	挺拔	峭拔	雄姿英發	雄峻挺拔	陽剛
奔放	豪放	恣意	縱橫	無拘無束	一瀉千里	揮灑自如	天馬行空	縱橫馳騁	龍飛鳳舞	鸞飄鳳泊	驚蛇入草	石破天驚	渾灑自如	龍翔鳳翥	無羈無束	雄赳赳
光明	美好	晟	成氣候	煒
清明	修明	夜不閉戶	路不拾遺	秋毫無犯	雞犬不驚
賞罰分明	信賞必罰	激濁揚清	彰善癉惡	獎罰分明
黑暗	暗無天日	漆黑一團	一團漆黑	天昏地暗	昏天黑地	烏煙瘴氣	烏七八糟	豺狼當道	道路以目	萬馬齊喑	敢怒而不敢言	天下烏鴉一般黑
腐敗	腐化	腐朽	腐爛	屍位	尸位素餐	文恬武嬉	官官相護	賄賂公行	貓鼠同眠
光榮	榮耀	榮	榮譽	榮華	榮幸	光耀	體面	好看	體體面面	威興我榮	無上光榮
不朽	永垂不朽	名垂青史	名垂千古	彪炳千古	彪炳史冊	重於泰山	死得其所	萬古流芳	流芳百世	流芳千古	青史名垂	彪炳春秋	千古不朽
衣錦還鄉	榮宗耀祖	金榜題名	揚名天下
可恥	羞恥	無恥	丟人	丟臉	丟醜	難看	難聽	愧赧	寒磣	丟面子	不要臉	不名譽	丟人現眼	見不得人	無恥之尤	恬不知恥	厚顏無恥	沒皮沒臉	奴顏婢膝	卑躬屈膝	喪權辱國	寡廉鮮恥	名譽掃地	威信掃地	斯文掃地	聲名狼藉	臭名昭著	臭名遠揚	遺臭萬年	劣跡昭著	羞與為伍	不知羞恥	沒臉	威風掃地	哀榮	掉價
著名	聞名	有名	知名	出名	老牌	名牌	頭面	響噹噹	名	紅	紅得發紫	赫赫有名	舉世聞名	聞名遐邇	鼎鼎大名	大名鼎鼎	如雷貫耳	出頭露面	顯赫一時	名噪一時	名震中外	舉世矚目	名滿天下	名揚天下	盡人皆知	婦孺皆知	老少皆知	資深	飲譽	聲名遠播	廣為人知	煊赫	名優特	甲天下	遐邇聞名	聞名遐邇	聲震寰宇	極負盛譽	顯赫	享譽
人心所向	眾望所歸	萬流景仰	年高德劭	德高望重
無名	默默無聞	無聲無臭	不見經傳	默默	前所未聞	名不見經傳	榜上無名
熱門	吃香	叫座	時興	熱	紅	俏	香	吃得開	緊俏	走俏	看好	人心向背	人人皆知	鸚鵡熱	熱點	搶手
冷門	冷	滯	背時	吃不開	無人問津	爆冷門
贏家	勝者	得主	勝利者
占上風	佔優勢
尊貴	高貴	顯貴	顯要	顯達	上流	大	貴	權威	出將入相	有頭有臉	高不可攀	惟它獨尊	獨尊	高於	勝過
貴	尊	雅	玉	台	華	令	賢	大	高	寶	鈞	惠	光	俯	垂	高高	醇雅	俊雅
低賤	卑微	微賤	輕賤	貧賤	下賤	賤	卑微	低微	低下	卑下	卑鄙	寒微	卑	微	低	低人一等	低三下四	人微言輕
敝	鄙	拙	賤	寒	下	愚	家	舍	小
貴重	名貴	寶貴	可貴	華貴	珍貴	珍	珍奇	珍異	金玉	難得	難能可貴	不菲	彌足珍貴	瑋
奇貨可居	價值連城	價值千金	無價	珍稀
一刻千金	寸土寸金	寸草寸金
昂貴	騰貴	高昂	值錢	貴	米珠薪桂	質次價高
便宜	賤	廉	低廉	廉價	公道	惠而不費	價廉物美	物美價廉	最低價	價廉	質優價廉	價廉質優	低價
重要	緊要	要緊	主要	顯要	首要	第一	要害	機要	重大	重點	要	要	根本	關鍵	非同小可	非同兒戲	舉足輕重	一言九鼎	生死攸關	事關重大	至關緊要	重要性	重在	著重	最主要	國本	性命交關	至關重要	生命攸關	嚴重性	必不可缺	重中之重	命運攸關	任重而道遠	利害攸關	基本點
中心	主導	主幹	核心	中堅	骨幹	基本	主從	挑大樑	著力	為重	為主
次要	其次	從	輔助	附帶	副	下	附有	說不上	第二性
不足道	微不足道	微末	區區	無所謂	開玩笑	無可無不可	可有可無	雞毛蒜皮	雞零狗碎	無關緊要	無足輕重	不足掛齒	雞蟲得失	不屑一顧	不值一提	不過爾爾	不過如此
不要緊	沒關係	沒什麼	沒事兒	舉重若輕
無傷大雅	無傷大體	無關大局	無關宏旨	無關痛癢	不痛不癢
緊急	緊迫	急迫	迫切	急切	火急	緊	急	亟	迫	急巴巴	十萬火急	急如星火	火燒眉毛	燃眉之急	迫不及待	迫在眉睫	刻不容緩	間不容髮	風風火火	時不我待	時不再來	事不宜遲	加急	情急之下
嚴重	慘重	深重	重	要緊	沉痛	不得了	不得了	人命關天	特重
驚人	可驚	震驚	觸目驚心	驚心動魄	聳人聽聞	危言聳聽	動魄驚心	危言聳聽
必要	必需	少不得	少不了	短不了	必不可少	不可或缺	必備	缺一不可	畫龍點睛
多餘	富餘	餘	蛇足	畫蛇添足	多此一舉	淨餘	不必要	不消	冗	衍	用不著
熟識	熟悉	熟稔	稔知	面熟	面善	眼熟	耳熟	常來常往	熟知	諳熟
陌生	生疏	面生	眼生	耳生	生	非親非故	素昧平生	人地生疏	生分	素不相識	來路不明	不諳
親密	密切	親切	親近	接近	親昵	親熱	相親	親愛	恩愛	熱和	近乎	莫逆	知己	知心	貼心	親	密	摯	近	不分彼此	親密無間	形影不離	形影相隨	相親相愛	寸步不離	如膠似漆	水乳交融	如魚得水	相見恨晚	相知恨晚	相依為命	心連心	心心相印	體貼入微	千絲萬縷	情同手足	親如手足	親如兄弟	骨肉相連	血肉相連	促膝	親親	可親	親親熱熱	親如一家	親親切切的	絲絲縷縷
唇亡齒寒	唇齒相依	輔車相依	山水相連	如影隨形	十指連心
鸞鳳和鳴	鴛鴦戲水	夫唱婦隨	白頭偕老	比翼雙飛
兒女情長	兩小無猜	青梅竹馬	耳鬢廝磨	卿卿我我
依戀	纏綿	繾綣	依依不捨	難捨難分	難解難分	打得火熱	情景交融	難分難解
疏遠	生疏	外道	遠	疏	視同陌路	視同路人	敬而遠之	親疏	不可向邇
若即若離	不即不離
和睦	和氣	和諧	諧和	調諧	諧調	協調	融洽	親善	友善	友好	友愛	投機	要好	相好	和好	好	團結	自己	大團結	和和氣氣	人和	溫馨	祥和	和樂	上下一心	對勁兒	闔家歡樂	團結一心	燮	談得來	敦睦
不和	不對	不對勁	彆扭	反目	同室操戈	彆彆扭扭	失和	積不相能
敵對	不共戴天	誓不兩立	你死我活	冰炭不相容	敵視	魚死網破	對抗性
緊密	嚴密	緻密	密緻	嚴緊	嚴謹	緊湊	連貫	接氣	一體	緊	環環相扣	絲絲入扣	一環扣一環	緊緊	聯貫	密不可分	密密的
鬆散	疏鬆	稀鬆	廢弛	松	散	鬆鬆垮垮	鬆氣	鬆鬆散散
單純	單一	純一	純粹	純淨	十足	足色	純	粹	單純性
複雜	繁雜	冗雜	繁複	煩冗	紛繁	盤根錯節	千頭萬緒	千絲萬縷	錯綜複雜	犬牙交錯	撲朔迷離	目迷五色	莫可名狀	縱橫交錯	繁體	紛紜複雜	複雜性	茫無頭緒	迷離撲朔	冗贅	卷帙浩繁	縟	苛
說來話長	一言難盡
重疊	臃腫	疊	層	疊床架屋	疊羅漢	重合	交匯	重重疊疊
瑣碎	瑣細	細碎	瑣	繁縟	委瑣	零碎	零星	雞零狗碎	針頭線腦	滴裡嘟嚕	零零碎碎
煩瑣	繁蕪	煩	麻煩	累贅	苛細	不勝其煩	繁瑣
簡單	簡略	簡約	簡短	簡易	簡便	粗略	省略	簡要	扼要	概括	大概	簡捷	簡明	簡練	簡	略	精煉	略去	簡簡單單	簡便易行	簡單易行	簡而言之	簡括	簡言之	說白了	從略	一筆帶過
詳細	詳盡	周詳	祥	縷	不厭其詳	詳詳細細	詳實	事無巨細	細大不捐	詳見	翔
透徹	透闢	透	淋漓	鞭辟入裡	淋漓盡致	酣暢淋漓
均勻	勻稱	勻淨	勻溜	勻整	勻實	勻和	停勻	平均	均衡	平衡	勻	均	年均	戶均	人均	隨遇平衡	動態平衡	均一	人平
調和	調勻	協調	和諧	諧和
平衡	失衡
廣泛	廣闊	寬廣	廣大	寬泛	普遍	周邊	廣	泛	大	常見	科普	周遍	漫無止境	大規模	大面積
無窮	無限	無期	無邊	無際	無邊無際	無窮無盡	海闊天空	漫無邊際	用不完	漫無際涯	一望無涯
狹隘	狹窄	窄小	狹小	窄	狹	小
豐富	豐厚	豐盛	豐碩	豐美	豐滿	豐沛	富足	富饒	豐盈	雄厚	豐	富	足	充足	充裕	從容	充實	充分	充暢	充沛	豐贍	裕	取之不盡	繁博	富集	富於	橫溢	宏贍	晟	沛	贍
廣博	淵博	奧博	博	博大	盛大	博採眾長	無所不有	地大物博	博識稔熟	恢宏博大	廣袤	博聞強志
貧乏	缺乏	短小	不足	緊張	枯窘	枯竭	匱乏	青黃不接	左支右絀	捉襟見肘	挖肉補瘡	匱
可愛	喜人	迷人	動人	宜人	媚人	可喜	可人	討人喜歡	喜聞樂見	楚楚可憐	憨態可掬	容態可掬	純情
明媚	柔媚
動人	感人	扣人心弦	動人心弦	感人肺腑	令人神往	引人入勝	沁人心脾	沁人肺腑	可歌可泣	迴腸盪氣	盪氣迴腸	振奮人心	頑石點頭
可怕	怕人	嚇人	駭然	駭人聽聞	人言可畏	唬人
可憎	可惡	可恨	可鄙	討厭	困人	惱人	煩人	該死	貧氣	臭	醜	貧	礙手礙腳	令人作嘔	面目可憎
傷	膩	膩煩	厭煩	倒胃口
深惡痛絕	千夫所指	不得人心
刺眼	礙眼
刺耳	難聽	逆耳	牙磣	不堪入耳
可憐	可憐巴巴
可笑	好笑	噴飯	捧腹	貽笑大方	笑話百出	笑掉大牙	洋相	令人捧腹
有趣	風趣	詼諧	幽默	趣	好玩兒	有意思	妙不可言	妙趣橫生	妙語如珠	饒有風趣	相映成趣	好玩	妙趣橫溢	詼	盎然	俳
滑稽	好笑	哏	逗	逗笑兒	逗樂兒	逗樂
帶勁	有勁	來勁	津津有味	津津樂道
枯燥	乾燥	枯澀	乏味	無味	平淡	瘟	乾癟	乾巴巴	味同嚼蠟	單調	沒趣	平平淡淡	索然無味	沒勁	沒意思
正常	如常	健康	正規	常規	好好兒	好端端	正常化	見怪不怪	例行
反常	失常	畸形	乖謬	乖戾	錯亂	尷尬	不對	不對頭	不對勁	不規則	怪	邪	邪門兒	不是味兒	歇斯底里	顛三倒四	語無倫次	反常規	顛過來倒過去	邪乎	非正常	詭
怪癖	特別	怪僻	怪聲怪氣	非僧非俗
奇怪	古怪	詭怪	怪誕	希奇	希罕	新奇	奇妙	奇特	離奇	奇異	怪異	怪	奇	蹊蹺	蹺蹊	詭異	詭譎	見鬼	活見鬼	光怪陸離	千奇百怪	怪裡怪氣	古裡古怪	怪模怪樣	怪誕不經	刁鑽古怪	無奇不有	聞所未聞	稀奇	稀奇古怪	好奇	奇幻	怪態	為怪	為奇	怪怪的
神奇	神異	瑰瑋	神乎其神	神差鬼使
不倫不類	不三不四	非驢非馬	莫名其妙
不可思議	天曉得	不知所云	不可名狀
可疑	有鬼
公開	公然	明	明白	明文	當眾	當面	大面兒上	桌面兒上	開誠佈公	光天化日	當著	堂而皇之	自明	公諸於世	兩公開	三公開	公之於世	四公開	明面兒
明目張膽	明火執仗
秘密	機密	絕密	機要	隱秘	神秘	詭秘	地下	潛在	私房	心腹	曖昧	暗昧	秘	私	密	黑	詳密	賊溜溜	神秘兮兮	秘聞
暗中	暗暗	暗自	暗	冷	偷	私下裡	私自	幕後	背後	背地裡	暗地裡	骨子裡	悄悄	偷偷	鬼祟	鬼鬼祟祟	鬼頭鬼腦	賊頭賊腦	探頭探腦	偷偷摸摸	不聲不響	一聲不響	秘而不宣	不露聲色	不動聲色	默默	潛	私下	體己	不可告人	悄悄的
合法	法定	官	官方
非法	不法	野雞	私自	地下	越軌	私	黑	暗	偽	非官方	非法定
明顯	顯明	顯著	昭著	昭彰	顯然	顯	陽	判	分明	明明	鮮明	明朗	明白	明瞭	簡明	詳明	醒豁	醒目	顯目	顯眼	扎眼	觸目	眼看	明確	肯定	強烈	斐然	犖犖	明擺著	眼見得	顯而易見	昭然若揭	黑白分明	彰明較著	有目共睹	眾目昭著	眾目睽睽	眾所周知	婦孺皆知	盡人皆知	家喻戶曉	舉世矚目	引人注目	一目了然	一覽無遺	洞若觀火	涇渭分明	不言而喻	無庸贅述	無可爭辯	此地無銀三百兩	醒眼	溢於言表	大庭廣眾	赫	判若鴻溝	旗幟鮮明	撥雲見日	確定性	昭昭	自不待言	吹糠見米
含糊	含糊	籠統	曖昧	模棱兩可	含含糊糊	含混	含混不清	不明	涇渭不分	打眼
隱約	隱隱	隱隱約約	語焉不詳	若隱若現	時隱時現	昭	倬
頂用	有用	中用	管用	合用	得力	頂事	管事	濟事	使得	實用	實惠	有效	對症	靈驗	靈光	靈通	靈	行	中	行之有效	立竿見影	可行	卓有成效	有效性	行得通
萬能	全天候
兩用	兩栖
有功	功勳	勞苦功高	功德無量	居功
無用	無效	失效	無益	廢	不行	空頭	不濟	不濟事	無濟於事	於事無補	以卵投石	與虎謀皮	杯水車薪	勞而無功	沒用	行不通	低效	不算
口惠	只說不做	空口說白話	口惠而實不至	假大空
徒勞	枉然	徒然	徒	空	瞎	虛	幹	白	乏	白搭	費力不討好	為人作嫁	一事無成	雞飛蛋打	畫脂鏤冰	白費力氣	枉費心機	徒勞無功	海底撈月	水中撈月	螳臂當車	蚍蜉撼大樹	問道於盲	緣木求魚	畫餅充饑	望梅止渴	隔靴搔癢	紙上談兵	對牛彈琴	揚湯止沸	賊去關門	蚍蜉撼樹	徒勞無益	勞而無獲
無償	義務	無條件	白	分文不取	白白	義診
便利	便當	便	方便	省便	省事	輕便	簡便	近便	穩便	靈便	活便	便捷	近水樓臺先得月	便民	地利	簡便易行	兩便	省心
手提式	手提
不便	麻煩	為難	難以	未便	礙事	礙難	難	礙口	礙手礙腳	難以啟齒
恰當	適當	得當	切當	允當	精當	相當	適宜	合宜	相宜	得宜	適合	合適	正好	確切	貼切	妥帖	熨帖	平妥	對頭	對路	得體	對勁	方便	適度	適量	適中	恰	宜	當	適	有分寸	恰如其分	恰到好處	適可而止	哀而不傷	不為已甚	適齡	適用	適於	宜於	當令	恰切	老少鹹宜	妥
各得其所	因地制宜	因人制宜	因時制宜	人盡其才	物盡其用
適時	及時	適逢其會	不冷不熱	可巧	不違農時
切題	照理
合身	稱身	可身	可體	合體
適口	合口味	下飯	下酒	歸口	專業對口
失當	不當	失宜	不宜	驢唇不對馬嘴	著三不著兩	不力
文不對題	不妥	欠妥
屈才	大材小用	牛鼎烹雞
以珠彈雀	明珠彈雀
妥當	妥善	停妥	妥實	服帖	穩妥	穩便	穩	穩當	停當	就緒	四平八穩	千了百當	計出萬全	服服帖帖	紋絲不動	穩穩當當
可靠	牢靠	牢穩	保險	篤定	把穩	吃准	靠得住	十拿九穩	百無一失	穩操勝券	穩操左券	穩拿把攥
天然	自然	天生	天賦	天稟	先天	生就	原始	天	原	生	自發	原貌	原狀	原生態	純天然	先天性	任其自然
天衣無縫	行雲流水
本來	原來	原本	原有	固有	故	舊	老	初	原	原始	土生土長	本來面目
現成	現	成	備
外來	外路	洋	番	夷	海	胡	旗	西
國產	國	華
土產	土
正規	正式	正經	正統	規範	標準	專業	科班	明媒正娶	正兒八經	正規化	業內
業餘	非正式	脫產
課餘	課外
雜牌	雜色
分內	本分	本職	當仁不讓	理所當然	義不容辭	非君莫屬	責無旁貸	匹夫有責	義無反顧	在所不辭	本本分分
分外	格外	額外	附加	外加
公	公共	官	集體	大我	公家	公私	公物	國有	共用
村務公開	半公開
私	私房	私有	個人	村辦	個體	民用	私家	個私
總	主	本	千	母	宏觀
分	支	岔	旁	子	分支	撥出	道岔	支行	汊港	分段	岔開	隔開	分層
禦	欽	上	敕	聖	龍	宸	天
皇	國	皇家	三皇
禪	梵	佛	僧	衲	武僧
胞	同胞	親生	血親	嫡親	嫡	塚
堂	堂房	嫡堂	叔伯	同房	從
表	中表
姑表	姑舅
姻	內	外	舅
寄	養	義	幹
繼	後	晚	後繼
庶	旁支	桑寄生
師	硯	學
盟	把	拜把
這個	這	此	斯	是	之	者	夫	其一	以此	本條
那個	那	彼	其	恁	該	夫	其二
某個	某	某某	有	某部	之一
各個	各	列	諸	每	各國	各級
其他	其它	其餘	別	別樣	另外	外	另	旁	另一個	任何
異	他	外	客
何	什麼	底	啥	嗎	甚
善良	善	好	樂善好施	助人為樂	仁至義盡	臧
仁慈	仁愛	慈善	慈祥	慈悲	慈	仁	臉軟	手軟	心慈面軟	慈眉善目	大慈大悲	菩薩心腸	慈愛	慈和	仁義	愛心	心慈手軟
兇惡	兇狠	兇橫	兇暴	強暴	橫暴	兇悍	邪惡	惡	凶	惡狠狠	殺氣騰騰	咬牙切齒	兇相畢露	窮凶極惡	金剛努目	橫眉怒目	橫眉豎眼	齜牙咧嘴	青面獠牙	張牙舞爪	醜惡	兇狂	猙獰	立眉瞪眼
惡毒	狠毒	刻毒	歹毒	毒辣	辣手	黑心	狠心	狠	毒	辣	心黑手辣	心狠手辣	殺人不見血	如狼似虎	豺狼成性	喪盡天良	喪心病狂	傷天害理	慘無人道	慘絕人寰	嗜殺成性	滅絕人性	趕盡殺絕	殺人如麻	殺人不眨眼	慘毒	不人道	傷天害命	為富不仁	毒辣辣	不顧死活
人面獸心	狼心狗肺	狠心腸	狠心狼
罪惡	萬惡	十惡不赦	怙惡不悛	罪大惡極	罪惡昭著	罪孽深重	罪該萬死	作惡多端	惡貫滿盈	五毒俱全	死有餘辜	罪不容誅	罪惡滔天
禍國殃民	草菅人命
兇殘	殘酷	殘暴	殘忍	暴虐	酷虐	暴戾	酷	暴戾恣睢	殘酷無情	殘酷無情
陰險	險惡	陰	險	賊	陰毒	陰騭	兇險	險詐	陰險毒辣	用心險惡	居心叵測	心懷叵測	包藏禍心	借刀殺人	人心惟危	笑裡藏刀	口蜜腹劍	佛口蛇心	兩面三刀	奸險	見風轉舵	虎視眈眈
厚道	忠厚	敦厚	溫厚	仁厚	寬厚	憨厚	篤厚	淳厚	渾厚	人道	渾樸	淳樸	純樸	誠樸	樸實	忠厚老實	不念舊惡	以德報怨	息事寧人	隱惡揚善	古道熱腸	憨直	厚朴	樸	以直報怨	憨	拙朴	醇樸	淳	惲	忍辱求全
刻薄	苛刻	尖刻	忌刻	冷峭	尖酸	尖酸刻薄	嚴苛
嘴尖	貧嘴	尖嘴薄舌	輕口薄舌	話裡帶刺	幸災樂禍
缺德	不仁	不仁不義	無仁無義	恩盡義絕	不道德	苛
正直	耿直	剛直	戇直	剛正	方正	中正	純正	雅正	矢	剛正不阿	大義凜然	耿	鯁直	伉	讜	梗直	胸無城府	錚	剛直不阿
坦率	坦白	磊落	襟	光明正大	光風霽月	問心無愧	明公正道	敢作敢為	堂皇正大	坦誠	胸懷坦蕩	正大光明	光明磊落	襟懷坦白	坦陳	赤裸
直率	率直	直爽	爽直	爽快	樸直	直截	簡捷	乾脆	痛快	幹	直	脆	露骨	公然	赤裸裸	直截了當	說一不二	開門見山	痛快淋漓	單刀直入	百無禁忌	直言不諱	無庸諱言	打開天窗說亮話	直捷	坦承
豪爽	爽朗	粗豪	粗獷	快	直性子	直腸子	有嘴無心	直來直去	慷
嘴快	心直口快	有口無心	開宗明義
婉轉	委婉	婉約	婉言	婉	含蓄	緩和	宛轉
轉彎	繞圈子	兜圈子	繞彎兒	轉彎抹角	拐彎抹角	藏頭露尾	旁敲側擊	繞彎子	轉彎子
含糊其辭	支吾其詞	欲言又止
話裡有話	意在言外	另有所指	指東說西	指桑駡槐
誠實	老實	規矩	信實	平實	樸質	心口如一	表裡如一	表裡一致	言行一致	說一不二	言而有信	信誓旦旦	敦	赤誠	懇	老老實實	樸	情真意摯	坦誠相見	推誠相見	仗義
刁滑	狡猾	狡獪	狡黠	奸猾	奸邪	奸佞	刁鑽	刁悍	刁頑	奸詐	狡詐	譎詐	詭詐	詭譎	刁	奸	別有用心	居心不良	口是心非	老奸巨猾	詭計多端	狡兔三窟	老奸巨滑
勢利	勢利眼	重富欺貧	欺軟怕硬	畏強欺弱	惟利是圖
真誠	熱誠	至誠	赤忱	虔誠	竭誠	精誠	誠摯	誠篤	誠懇	懇切	純真	真摯	懇摯	深摯	真率	率真	義氣	誠心	實心	真心	傾心	衷心	由衷	真切	熱切	殷切	殷殷	諄諄	拳拳	誠	真心誠意	誠心誠意	真心實意	實心實意	開誠相見	開誠佈公	肝膽相照	披肝瀝膽	口陳肝膽	推心置腹	摯誠	拳拳之心	諶
虛偽	偽善	假	兩面派	假惺惺	巧言令色	假仁假義	陽奉陰違	虛與委蛇	虛應故事	貓哭老鼠	鱷魚眼淚	弄虛作假	假眉三道	道貌岸然
忠誠	忠	篤	忠貞	忠實	篤實	忠心耿耿	披肝瀝膽	忠貞不二	赤膽忠心	忠骨	忠於	忠於職守
叛逆	忤逆	逆	異	貳	大不敬	大逆不道	六親不認	離經叛道	忤逆不孝	愚忠	不孝	忤
溫柔	溫和	溫存	溫潤	和氣	和善	和易	和藹	和約	平易近人	好說話兒	好聲好氣	和顏悅色	和藹可親	和和氣氣	和悅	親和
暴躁	暴烈	火性	粗暴	暴	暴	躁	烈
溫順	和順	恭順	忠順	馴順	馴熟	馴服	馴良	柔順	隨和	乖	百依百順	與人無爭	一團和氣	溫馴	馴熟
聽話	聽說	聽從	俯首貼耳	惟命是從	奉命唯謹	言聽計從	唯唯諾諾	唯命是從	千依百順	奉命唯謹
孝順	孝
倔強	倔	強	拗	倔頭倔腦	強頭強腦	倔強	強勁
不甘	不甘心	不甘示弱	不甘寂寞
乖僻	乖張	乖戾	桀驁不馴
樂觀	樂天	達觀	開朗	開闊	開豁	開展	明朗	想得開	無憂無慮	自得其樂	樂天知命	知足常樂	逍遙自得	以苦為樂	樂觀主義	有望
悲觀	想不開	鬱鬱寡歡	悲觀失望	杞人憂天	聽天由命	萬念俱灰	心如死灰	槁木死灰	不容樂觀
嚴肅	嚴厲	嚴峻	凜然	儼然	愀然	正色	厲聲	一本正經	凜若冰霜	不苟言笑	聲色俱厲	疾言厲色	正襟危坐	凜	義正辭嚴	正顏厲色	肅然	正氣凜然	肅
活潑	活躍	歡	歡躍	生動活潑	生氣勃勃	生龍活虎	歡蹦亂跳	龍騰虎躍	生意盎然	一片生機	虎虎有生氣	外向	活蹦亂跳	活潑潑
頑皮	調皮	皮	淘氣	頑
瀟灑	灑脫	灑落	跌宕	翩翩	飄逸	風流	自然	大方	落落大方	葛巾羽扇	指揮若定	瀟灑不羈	俊發飄逸	俠氣
豪放	不羈	豪爽	超脫	曠達	豪放不羈	爽利	慷	慨
拘束	拘謹	矜持	局促	拘板	拘禮	拘泥	靦腆	束手束腳	縮手縮腳	扭扭捏捏	局促不安
消遙	自在	自得	消遙自在	悠閒自在	無拘無束	悠哉遊哉	自由自在	自得其樂	逍遙	無羈無束
安分	本分	規矩	老實	安分守己	安守本分	循規蹈矩	規行矩步	老實巴交	隨遇而安	安貧樂道	與世無爭	渾俗和光	和光同塵	奉公守法	既來之	本本分分	規規矩矩
放肆	放縱	放誕	倡狂	猖獗	囂張	恣意	恣肆	非分	驕縱	驕橫	狂妄	狂	愚妄	浪	膽大妄為	恣意妄為	自作主張	隨心所欲	為所欲為	無法無天	目無法紀	目中無人	肆無忌憚	百無禁忌	毫無顧慮	旁若無人	有恃無恐	有天沒日	明目張膽	明火執仗	橫行無忌	胡作非為	失態	肆無忌彈	張揚	甚囂塵上	群龍無首	招搖	不顧一切	狂妄自大
散漫	疏懶	隨便	不在乎	無所謂	大大咧咧	鬆鬆垮垮	吊兒郎當	從心所欲	大咧咧	隨隨便便
放蕩	荒唐	放蕩	放浪	放浪形骸	放蕩不羈	落拓不羈	不拘小節	玩世不恭	不修邊幅	浪蕩	毫無顧忌
果斷	決斷	果敢	果決	堅決	潑辣	毅然	決然	斷然	毅然決然	大刀闊斧	快刀斬亂麻	乾脆俐落	當機立斷	毫不猶豫	二話不說
堅強	剛強	頑強	鋼鐵	不屈	剛烈	剛直	剛毅	沉毅	強項	硬氣	烈性	血性	血氣	烈	硬	剛	百折不撓	百煉成鋼	威武不屈	堅強不屈	堅貞不屈	寧死不屈	不屈不撓	萬死不辭	錚錚鐵骨	百折不回	不折不撓	窮當益堅	身殘志堅	寧為玉碎	毅	忠貞不屈	堅毅不屈
剛柔相濟	綿裡藏針	疾風勁草	鐵石心腸	硬性
堅定	堅	堅決	死活	堅忍	堅貞	堅忍不拔	矢志不移	有志竟成	鍥而不捨	斬釘截鐵	海枯石爛	堅定不移	破釜沉舟	巋然不動	雷打不動	木人石心	精衛填海	鐵板釘釘	堅苦	堅韌不拔	執著	堅毅	堅勁	堅貞不渝	萬劫不渝	生死不渝	不懈	意志力
脆弱	軟弱	薄弱	懦弱	軟	婆婆媽媽	嬌生慣養	耳軟心活	懦	意志薄弱者
勇敢	勇	敢	勇於	敢於	英勇	驍勇	神勇	勇猛	勇武	英武	英雄	大膽	斗膽	膽大	剽悍	強悍	大無畏	一身是膽	膽大包天	群威群膽	奮不顧身	赴湯蹈火	出生入死	捨生忘死	視死如歸	萬死不辭	臨危不懼	無所畏懼	了無懼色	履險如夷	身先士卒	萬夫莫當	神威	首當其衝	挺身	無畏	披荊斬棘	劈風斬浪	匹夫之勇	破馬張飛	打抱不平	奮勇	奮勇當先	虎勁	急流勇進	見義勇為	不避艱險	颯爽	驍	有種	不怕犧牲	威猛	竟敢
有勇有謀	大智大勇	智勇雙全	越戰越勇
怯懦	怯弱	愚懦	膽小	膽虛	膽怯	卑怯	怯生生	心虛	草雞	窩囊	孬	膽小如鼠	膽小怕事	畏首畏尾	縮頭縮腦	鉗口結舌	唯唯諾諾	怯聲怯氣	貪生怕死	苟且偷安	不敢越雷池一步	矯	縮頭	怵頭	怯	委曲求全
聰明	聰慧	明慧	智慧	聰穎	穎悟	靈性	穎慧	慧黠	內秀	明白	智	小聰明	秀外慧中	耳聰目明	足智多謀	大智若愚	聰敏	生財有道	有頭有腦	聰明伶俐	大巧若拙	多謀善斷	穎慧	精明能幹	靈氣	雋	能者	早慧	融智
過目不忘	過目成誦	一目十行	才思敏捷
英明	明智	睿智	精明	神	料事如神	獨具隻眼	明察秋毫	見微知著	金睛火眼	睿	英名蓋世
愚笨	笨拙	拙笨	迂拙	愚蠢	愚笨	愚拙	愚魯	愚昧	癡呆	呆笨	粗笨	傻氣	傻勁兒	笨	拙	癡	蠢	愚	傻	傻呵呵	傻裡傻氣	愚不可及	愚昧無知	昏頭轉向	買櫝還珠	騎馬找馬	缺心眼兒	傻乎乎	不靈	蠢笨	蠢物	舍珠買櫝	懵	昏昏然	愚鈍	弱質	五音不全
糊塗	悖晦	發蒙	蒙昧	懵懂	顢頇	馬大哈	暗	昏庸	昏聵	糊裡糊塗	稀裡糊塗	昏頭昏腦	渾頭渾腦	暈頭轉向	矇頭轉向	迷迷糊糊	如墮煙海	如坐雲霧	如墮五里霧中	當局者迷	糊塗	聰明一世
機智	機靈	機敏	機警	靈巧	靈敏	靈活	精靈	玲瓏	機巧	乖巧	乖覺	敏銳	銳敏	敏感	伶俐	靈	快	隨機應變	臨機應變	通權達變	便宜行事	見機行事	手急眼快	相機行事	牙白口清	眼明手快	人傑地靈	聰	急智	能屈能伸	千伶百俐	聰明伶俐	耳聽八方	敏銳性	靈動	趁機	能進能出
魯鈍	遲鈍	頑鈍	駑鈍	呆笨	呆	木訥	訥訥	呆頭呆腦	張口結舌	笨口拙舌	笨手笨腳	木雕泥塑	泥塑木雕	木頭疙瘩	怯頭怯腦	呆傻	呆愣愣	癡呆呆	呆呆地
圓滑	渾圓	油滑	世故	兩面光	八面玲瓏	隨大溜	隨風倒	隨波逐流	見風使舵	隨風轉舵	鑒貌辨色	人云亦云	靈活性	看人下菜	八面光	混水摸魚	看風使舵
滑頭	油	滑	油頭滑腦	滑頭滑腦	聰
油嘴	油腔滑調	油嘴滑舌	輕嘴薄舌	順風轉舵
刻板	古板	死板	呆板	死	板	一板一眼	板板六十四	劃一不二	依樣畫葫蘆	膠柱鼓瑟	刻舟求劍	守株待兔	按圖索驥	食古不化	率由舊章	毒化	死腦筋	死心塌地	固執己見	不到黃河心不死	不識抬舉	拘于	姜太公釣魚
教條	機械	公式化	教條主義	本本主義	照本宣科	形而上學
固執	執拗	愚頑	頑固	死硬	僵硬	頑梗	執著	剛愎	剛愎自用	一個心眼兒	頑固不化	泥古不化	師心自用	自以為是	一意孤行	執迷不悟	至死不悟	不識時務	諱疾忌醫	屢教不改	秉性難移	自行其是	偏執
靈巧	靈活	靈	巧	活	靈便	靈敏	圓通	手巧	麻利	利索	俐落	活絡	心靈手巧	新巧	眼疾
心靈	眼尖	手快	眼明手快	手疾眼快	眼疾手快	快人快語
能幹	精幹	精悍	得力	賢明	英明	高明	能	行	成	有兩下子	精明強幹	神通廣大	遊刃有餘	教子有方	有方	技高一籌	技壓群雄	領導有方	精明能幹
全能	萬能	無所不能	全知全能	文武全才	文武雙全	多才多藝	左右開弓	一專多能	能文能武	能者為師	能者多勞
善戰	以一當十	用兵如神	膽識過人	短小精悍
妙手回春	手到病除	起死回生	起手回春
健談	對答如流	口若懸河	巧舌如簧	能言善辯	辯才無礙	語驚四座	伶牙俐齒
獨具慧眼	獨具隻眼	慧眼獨具
出口成章	文不加點	一揮而就	下筆成章	妙語連珠
無能	低能	差勁	庸碌	平庸	凡庸	碌碌	碌碌無能	志大才疏	一無所長	尸位素餐	弱智	庸庸碌碌	經營不善	高分低能
博學	飽學	宏達	博學多才	博大精深	博古通今	博覽群書	見多識廣	學有專長	無所不知	滿腹經綸	滿腹珠璣	博聞強記	才高八斗	陸海潘江	金玉滿堂	通今博古	博聞強識	博雅	才華橫溢	碩學
淺學	淺薄	淺陋	鄙陋	半瓶醋	半吊子	才疏學淺	略識之無	淺嘗輒止	不求甚解	譾
孤陋寡聞	少見多怪	蜀犬吠日	識文斷字
無知	蒙昧	愚昧	愚蒙	愚陋	混沌	愚昧無知	一無所知	一竅不通	一問三不知	目不識丁	胸無點墨	不學無術	漆黑一團	冥頑不靈	渾渾噩噩	不辨菽麥	五穀不分	渾沌一片	蚩	發懵
有為	成器	成材	年輕有為	奮發有為	大有作為	大有可為	前程似錦	前程萬里	鵬程萬里	前途無量	春秋正富	春秋鼎盛	壯志淩雲	孺子可教	後生可畏	大器晚成	老驥伏櫪	有所作為	成才	得道多助	老有所為	前程錦繡
不成材	不成器	沒出息	碌碌	不可救藥	碌碌無為	無所作為	不務正業	不郎不秀	累教不改	邪門歪道	胸無大志	不稂不莠
卓有遠見	目光如炬	高瞻遠矚	志在千里	鴻鵠之志
目光如豆	目光短淺	鼠目寸光	近視	坐井觀天	不識大體	飲鴆止渴	急功近利	求田問舍	散光	有眼無珠	雞口牛後	雞屍牛從	短視
老練	幹練	老到	老成	老氣	老辣	老	練達	成熟	老謀深算	深謀遠慮	老成持重	少年老成	曾經滄海	飽經風霜	老馬識途	老于世故	老道	早熟	多謀善算者
幼稚	天真	純真	稚氣	嬌憨	孩子氣	天真爛漫	天真無邪	沒深沒淺	沒心沒肺	癡人說夢	嬌癡	稚嫩	童心未泯	童真
少不更事	羽毛未豐	乳臭未乾	初出茅廬	涉世不深	稚氣未脫
熟練	純熟	嫺熟	圓熟	爛熟	熟	純	穩練	諳練	在行	內行	懂行	見長	訓練有素	科班出身	滾瓜爛熟	爐火純青	目無全牛	遊刃有餘	駕輕就熟	運用自如	揮灑自如	如臂使指	得心應手	滾瓜流油	熟能生巧	自如	運用裕如	融匯貫通
生疏	夾生	生	外行	半路出家	生僻
荒疏	荒
積極	主動	肯幹	幹勁衝天	知難而進	力爭上游	再接再厲	當仁不讓	積極性	能動	積極向上
消極	被動	消沉	低沉	低落	無所作為	聽天由命	得過且過	與世無爭	看破紅塵	四大皆空	甘居中游	知難而退	做一天和尚撞一天鐘	半死不活
勤奮	勤勉	勤勞	勤懇	勤快	勤謹	勤	手勤	勤苦	辛勤	努力	奮勉	巴結	孜孜不倦	篤行不倦	臥薪嚐膽	櫛風沐雨	吃苦耐勞	不辭辛勞	不辭勞苦	任勞任怨	摩頂放踵	事必躬親	身體力行	發憤忘食	廢寢忘食	笨鳥先飛	精衛填海	磨杵成針	鍥而不捨	有志竟成	下大力	勤儉持家	忘我工作	勤於	賣勁	懋
閒不住	戴月披星	夜以繼日	日以繼夜	焚膏繼晷	爭分奪秒	分秒必爭	見縫插針	只爭朝夕	夙興夜寐	朝乾夕惕	不辭辛苦	勒石記痛	早出晚歸	孜孜	孜孜以求	起早貪黑	勤奮好學	勤勤懇懇	盡瘁鞠躬	刻苦耐勞	發憤	奮發進取	不畏難辛
用功	用心	篤學	好學	苦讀	苦學	啃書本	手不釋卷	十年寒窗	學而不厭	勤學苦練	目不窺園	無日無夜	下功夫	懸樑刺股	十年一劍	十年磨一劍	較勁
懶惰	懶	懶散	懈怠	怠惰	窳惰	好吃懶做	好逸惡勞	四體不勤	拈輕怕重	悠悠忽忽	飽食終日	無所用心	遊手好閒	見縫就鑽	飯來張口	懈	惰
拖拉	拖遝	疲遝	拖泥帶水	疲遝	拖三拉四	拖拖拉拉
有恆	恒久	持久	有始有終	善始善終	愚公移山	持之以恆	全始全終	始終如一	堅持不渝	始終不渝	鍥而不捨	滴水穿石	水滴石穿	磨杵成針	繩鋸木斷	持久	持之有故	堅持不懈	始終不懈	有頭有尾	從始至終	慎始而敬終	慎始敬終	由始至終	從頭到尾	一抓到底
無恒	有始無終	有頭無尾	虎頭蛇尾	斷斷續續	一暴十寒	斷續	時斷時續
節約	節省	省	儉省	儉樸	節儉	刻苦	樸素	節衣縮食	縮衣節食	克勤克儉	省吃儉用	簞食瓢飲	粗茶淡飯	精打細算	寬打窄用	細水長流	開源節流	量入為出	堅苦	節能	厲行節約	勤儉	勤儉節約	勤政	省力	勤政廉政	省時	勤政廉潔	廉政勤政	節電	儉	粗衣淡食	省卻	廉潔勤政	仔細
奢侈	浪費	鋪張	奢靡	奢華	糜費	揮霍	鋪張浪費	窮奢極侈	驕奢淫逸	大手大腳	一擲千金	千金一擲	揮金如土	暴殄天物	大吃大喝	花天酒地	紙醉金迷	金迷紙醉	燈紅酒綠	醉生夢死	酒池肉林	錦衣玉食	鐘鳴鼎食	輕裘肥馬	奢	奢侈浪費	奢糜	大操大辦	侈
認真	頂真	較真	負責	一本正經	正經八百	事必躬親	一絲不苟	嘔心瀝血	敬業	恪盡職守	愛崗敬業	動真格	敬業愛崗	精研細磨	認認真真	兢	較真兒
馬虎	含糊	草率	潦草	草	草草	浮皮潦草	虛應故事	漫不經心	掉以輕心	丟三落四	粗製濫造	偷工減料	膚皮潦草	含含糊糊	不負
仔細	細	過細	細緻	細密	縝密	緻密	周密	綿密	密切	精到	精心	細心	心細	精雕細刻	細針密縷	條分縷析	膽大心細	逐字逐句	仔仔細細	有心人	明細	細瞧	細緻入微	嚴細
粗心	粗	粗率	粗疏	疏忽	失慎	馬大哈	粗枝大葉	缺心少肺	粗心大意	疏於	虎氣
毛手毛腳	沒頭沒腦
謹慎	勤謹	嚴謹	謹	審慎	當心	小心	小心謹慎	小心翼翼	謹言慎行	字斟句酌	謹小慎微	奉命唯謹	戰戰兢兢	兢兢業業	臨深履薄	三思而行	謹而慎之	兢	競	毖
口緊	嘴緊	嘴穩	守口如瓶	三緘其口
慎重	鄭重	鄭重其事
知趣	識趣	識相
輕率	魯莽	莽撞	冒失	冒昧	孟浪	造次	貿然	率爾	唐突	愣	愣頭愣腦	率爾操觚	視同兒戲	不知死活	不知進退	不管不顧	不管三七二十一	猴手猴腳	鹵莽	魯	冒失鬼	不慎	一不小心	出言不慎	稍有不慎
荒唐	荒誕
穩重	穩健	沉穩	把穩	持重	莊重	凝重	莊嚴	端莊	端詳	安詳	安穩	老成持重	不苟言笑	四平八穩	寵辱不驚	舉止端莊	儼	拙樸
踏實	塌實	扎實	樸實	實在	腳踏實地	步步為營	穩紮穩打	一步一個腳印兒	踏踏實實	安安穩穩	樸	實幹	扎扎實實	沉實	照實	一步一個腳印
輕浮	浮	漂浮	輕飄	輕狂	張狂	輕舉妄動	心浮	虛浮
耐心	耐性	耐煩	誨人不倦	不厭其煩	苦口婆心
苦心	煞費苦心	苦心孤詣	煞費心機
急躁	浮躁	褊急	急性	性急	操切	操之過急	氣急敗壞	毛躁	欲速不達	不耐煩	心浮氣躁	躁動	躁動不安
文雅	風雅	嫻雅	清雅	儒雅	文明	文靜	嫺靜	秀氣	斯文	大方	雍容	文縐縐	文質彬彬	彬彬有禮	溫文爾雅	風度翩翩	曲水流觴	山清水秀	文明禮貌	文武	文文靜靜	彬	彬彬	斌
粗暴	粗魯	粗獷	獷悍	粗野	粗	野	野蠻	狂暴	不遜	粗裡粗氣	村野	老粗	強行	蠻荒
清高	孤高	孤傲	淡泊	恬淡	出世	脫俗	超脫	超逸	與世無爭	潔身自好	落落寡合	特立獨行	孤芳自賞	超然物外	富貴浮雲	淡泊名利
虛榮	好勝	愛面子	好高騖遠	好大喜功	沽名釣譽	好強	眼高手低	講面子
恭敬	虔敬	恭謹	尊敬	尊重	敬	拜	肅然起敬	畢恭畢敬	相敬如賓	舉案齊眉	正襟危坐	必恭必敬	恭	恭恭敬敬	可敬	虔	寅
敬老	尊老敬老	尊老	敬老養老
客氣	殷勤	殷	賓至如歸	客客氣氣	卻之不恭
簡慢	怠慢	輕慢	非禮	失禮	不周	毫不客氣	怠	索然
熱情	熱心	熱忱	熱心腸	好客	滿腔熱忱	古道熱腸	有求必應	來者不拒	急人之難	急人所急	滿腔熱情	滿懷深情	熱情洋溢	善款
冷淡	冷漠	冰冷	淡漠	淡然	淡淡	淡	冷	冷冰冰	冷言冷語	陰陽怪氣	似理非理	漠不關心	冷眉冷眼	生冷	冷酷	漠然	漠然視之	見外	冷豔	冷峻
謙虛	謙遜	謙恭	謙卑	謙和	過謙	虛心	客氣	謙虛謹慎	虛懷若谷	不恥下問	聞過則喜	功成不居	勞不矜功	謙
深藏若虛	大智若愚	自豪	兼聽則明	居功不傲	不卑不亢	不驕不躁	不亢不卑	淡泊明志	超然
自卑	卑	妄自菲薄	自輕自賤	自慚形穢
恭順	低聲下氣	低三下四	低首下心	奉命唯謹	唯唯諾諾	卑躬屈膝	搖尾乞憐	奴顏媚骨	奴顏婢膝	目不見睫	媚顏
驕傲	驕矜	矜誇	驕	滿	傲	傲慢	驕慢	神氣	高傲	傲視	傲岸	自負	自居	自誇	自用	自是	自大	孤高	不自量力	翹尾巴	自高自大	自以為是	驕傲自滿	居功自傲	妄自尊大	好為人師	夜郎自大	不可一世	自命不凡	惟我獨尊	旁若無人	目中無人	目無餘子	目空一切	鋒芒畢露	盛氣淩人	呼么喝六	老氣橫秋	以老賣老	恃才傲物	有恃無恐	大言不慚	出言不遜	得意忘形	忘乎所以	顧盼自雄	耀武揚威	趾高氣揚	神氣活現	頤指氣使	高視闊步	大模大樣	老虎屁股摸不得	作威作福	倨	自滿	自傲	煞有介事	自不量力	輕世傲物	傲然	目指氣使	居功自恃	不自量	冷傲	倨傲不恭	唯我獨尊	矜	衝昏頭腦	狂傲	洋洋自得	人莫予毒
引以自豪	成就感
大度	大量	大方	大氣	雅量	豁達	曠達	恢宏	不念舊惡	滿不在乎	豁達大度	汪洋	大大方方	氣勢恢宏	坦坦蕩蕩
慷慨	慨然	俠義	捨己為人	急公好義	先人後己	慨當以慷	豁朗	捨己為公	捨身為國	舍已為公	慷	慷慨大方	不吝
夠交情	夠朋友
手松	大方	不在乎	大手大腳
心窄	小心眼	小肚雞腸	鼠肚雞腸	雞腸鼠肚	不夠意思
吝嗇	慳吝	鄙吝	貧氣	手緊	小氣	摳	錢串子	小手小腳	小家子氣	小兒科	斤斤計較	分斤掰兩	掂斤播兩	數米而炊	一毛不拔	鐵算盤	嗇	摳門	摳摳搜搜
嚴格	嚴厲	嚴酷	嚴峻	嚴	從嚴	嚴詞	執法必嚴	嚴苛	嚴細	從緊	嚴加	適度從緊
軍令如山	執法如山	言出法隨	令行禁止	森嚴	從嚴治政	森嚴壁壘
寬大	寬	寬大為懷	寬宏大量	網開一面	不咎既往	既往不咎	手下留情	網開三面	寬鬆	寬限	從寬	從輕	不嚴
革命	紅色	紅	赤	辛亥革命	又紅又專	代代紅	新民主主義革命
反動	反革命	白色	白	逆
進步	先進	上進	紅旗	進取	力爭上游	不甘示弱	產業革命	學好
急進	激進
落後	後進	落伍	滯後
民主	群言堂
專制	獨裁	專斷	專權	擅權	武斷	獨斷	一言堂	獨斷獨行	一意孤行	一手遮天	孤行己見	大權獨攬	不容置喙	生殺予奪	獨斷專行
講理	通達	達	通情達理	明達	知情達理
蠻橫	強橫	霸道	跋扈	橫暴	驕橫	強暴	悍然	豪強	豪橫	潑辣	無賴	暴	橫	蠻	不近人情	不可理喻	不由分說	強詞奪理	強橫霸道	蠻不講理	蠻橫無理	橫行霸道	橫行無忌	稱王稱霸	專橫跋扈	飛揚跋扈	肆無忌憚	橫蠻	專橫	蠻幹	霸氣
開通	開展	開明	通達	通情達理	知情達理
保守	守舊	封建	陳腐	迂腐	迂	窮酸	抱殘守缺	墨守成規	因循守舊	陳陳相因	安於現狀	固步自封	率由舊章	一仍舊貫	蹈常襲故	蕭規曹隨	步人後塵	等因奉此	閉關鎖國	閉關自守	故步自封	墨守陳規	安於	半封建	寒酸	方巾氣
公正	正義	公道	公	公平	持平	平允	公允	天公地道	不偏不倚	一視同仁	童叟無欺	老少無欺	公事公辦	公正無私	愛恨分明	秉公	不徇私情
嚴明	明鏡高懸	秦鏡高懸	鐵面無私	獎罰分明	嫉惡如仇
偏心	偏	一偏	偏頗	偏袒	左袒	左右袒	不公	不平	厚此薄彼	偏聽偏信	吃獨食	徇情枉法	劫富濟貧	厚古薄今	吃偏飯	偏失
無私	大公無私	公而忘私	大義滅親	捨身為國	廉正無私	捨己為公
克己奉公	枵腹從公	涓滴歸公
捨己為人	捨己救人	見危授命	毫不利己
先人後己	吃苦在前	天下為公	忘我	無私	無私無畏	享樂在後
自私	私	自私自利	患得患失	損人利己	見利忘義	明哲保身	利己	損公肥私	化公為私	丟卒保車	獨善其身
廉潔	清廉	廉正	廉明	廉	廉潔奉公	兩袖清風	清風兩袖	一塵不染	一身清白	水米無交	清正	廉政	道不拾遺	反腐倡廉	廉政勤政	清正廉潔	潔身自律	廉潔自律	肅貪倡廉
貪心	貪	貪婪	貪戀	貪欲	唯利是圖	利令智昏	利慾薰心	饞涎欲滴	垂涎三尺	野心勃勃	貪得無厭	貪心不足	欲壑難填	得寸進尺	得隴望蜀	名韁利鎖	權慾薰心	垂涎欲滴	貪婪無厭	貪大求全	貪求	不廉	淫心	物欲橫流
見錢眼開	財迷心竅	愛財如命	虎視眈眈	見財起意
貪財	貪多	貪天之功
高尚	高貴	崇高	神聖	高風亮節	高雅	亮節高風	出塵脫俗	超凡脫俗	涅而不緇
正派	正經	正直	正當	正面	莊重	端正	純正	方正	端莊	尊重	自重	自愛	目不斜視	儼	不俗	雅俗
庸俗	粗俗	鄙俗	俚俗	傖俗	俗氣	俗	粗鄙	鄙俚	鄙吝	猥瑣	委瑣	世俗	無聊	百無聊賴	低俗	凡俗
下流	下作	下賤	猥賤	卑賤	卑鄙	卑劣	卑污	猥劣	猥鄙	齷齪	不端	不肖	不要臉	髒	穢	不三不四	見不得人	不堪入目	蠅營狗苟	媚俗
貞潔	貞烈	節烈	烈	貞	從一而終	純潔性
純潔	高潔	聖潔	天真	清白	一清二白	一塵不染	冰清玉潔	玉潔冰清	白璧無瑕	童貞	丰韻	清清白白
輕佻	輕薄	輕狂	浪漫	風騷	騷	妖豔	妖冶	妖媚	肉麻	癲狂	狎昵	嗲	嗲聲嗲氣	妖裡妖氣	搔首弄姿	油頭粉面	有傷風化	性感	儇
淫蕩	淫亂	荒淫	好色	猥褻	淫褻	淫穢	淫猥	浪	荒淫無恥	聲色犬馬	水性楊花	傷風敗俗	蕩檢逾閑	淫糜
色情	香豔	豔情	豔	韻	桃色	黃色	風流	羅曼蒂克	貪色
多情	癡情	脈脈	脈脈含情	溫情脈脈	兒女情長	多愁善感	柔情似水	一往情深
薄情	喜新厭舊
無情	負心	冷酷無情	無情無義	過河拆橋	鳥盡弓藏	得魚忘筌	兔死狗烹	卸磨殺驢	忘恩負義	恩將仇報	以怨報德	鐵石心腸	有理無情
太平	升平	承平	治世	清明	天下大治	天下太平	國泰民安	河清海晏	堯天舜日	鶯歌燕舞	太平無事	平平靜靜	謐	歌舞昇平
和平	相安無事	一方平安
安定	平安	穩定	安生	平靜	安靜	安寧	安謐	安瀾	安樂	康樂	風平浪靜	安居樂業	平服	穩定性	家弦戶誦	祥和	政通人和	平穩	平安無事	長治久安	安定團結	宓	安外	安居	綏	泰
動盪	波動	不安	不定	亂	變亂	動亂	騷亂	多事	騷動	洶洶	搖擺不定	動盪不安	人心浮動	風雨飄搖	滄海橫流	兵荒馬亂	兵連禍結	狼煙四起	內憂外患	雞犬不寧	天翻地覆	天下大亂	荒亂	捉摸不定	動盪不定	岌岌	忽左忽右	遊走不定
混亂	紛亂	紛擾	擾亂	淆亂	亂騰	紛紛	亂糟糟	亂哄哄	心神不寧	人多嘴雜	困擾	狂亂	狂躁
繁榮	景氣	發達	興旺	旺	盛	興盛	繁盛	昌盛	強盛	鼎盛	日隆旺盛	熾盛	全盛	興隆	榮華	昌明	蓬勃	勃勃	沸騰	熱火朝天	人歡馬叫	萬馬奔騰	百廢俱興	欣欣向榮	繁榮昌盛	萬古長青	根深葉茂	本固枝榮	如日中天	方興未艾	蒸蒸日上	雲蒸霞蔚	氣象萬千	百花齊放	滿園春色	萬紫千紅	盛極一時	勃	勃然	昌	興旺發達	樹大根深	春色滿園	紅紅火火	生機勃勃	萬紫千紅春滿園	千花競秀	生機蓬勃	生機盎然	興邦	蓬勃向上	蓬蓬勃勃
蕭條	冷淡	清淡	零落	百業待興	低迷	百廢待興	走低
凋敝	凋零	衰落	沒落	敗落	破落	衰敗	頹敗	衰微	式微	衰頹	衰退	衰朽	闌珊	陵替	衰	淡	不景氣	強弩之末	日暮途窮	日薄西山	桑榆暮景	大勢已去	一落千丈	一蹶不振	每況愈下	千瘡百孔	百孔千瘡	氣息奄奄	苟延殘喘	再衰三竭	落花流水	萎靡	衰竭	稀落
天下興亡	千古興亡	盛衰	盛衰榮辱	興衰	興亡
熱鬧	繁華	紅火	火暴	鑼鼓喧天	敲鑼打鼓	吹吹打打	載歌載舞	急管繁弦	隆重	熱熱鬧鬧	紅極一時	酒綠燈紅	熱鬧非凡
熙熙攘攘	熙來攘往	人來人往	門庭若市	履舄交錯	車馬盈門	車水馬龍	萬人空巷	人山人海	聞訊而來	熙攘
喧嘩	鬧	吵	鬧騰	喧鬧	喧騰	嘈雜	塵囂	沸騰	鼎沸	譁然	哄然	喧嚷	鼓噪	吵鬧	喧囂	洶洶	煩囂	聒耳	聒噪	嚷嚷	嚷	鬧嚷嚷	鬧哄哄	亂哄哄	鬧翻天	七嘴八舌	沸沸揚揚	沸反盈天	轟然	嘩	嬉鬧	蜂擁而上	喧聲四起
擁擠	擠	軋	蜂擁	擠擠插插	人山人海	水泄不通	磕頭碰腦	前呼後擁	摩肩接踵	肩摩轂擊	項背相望	冠蓋相望	熙熙攘攘	熙來攘往	擁擠不堪	人多嘴雜	人頭攢動	肩摩踵接	擁堵	擁簇	人滿為患	塞車
安靜	恬靜	寧靜	冷靜	清靜	沉靜	寂靜	肅靜	僻靜	幽靜	清淨	靜穆	漠漠	寂寂	沉寂	冷寂	幽寂	清幽	幽深	寂然	岑寂	靜謐	廓落	靜	靜悄悄	夜靜更深	夜闌人靜	夜深人靜	鴉雀無聲	啞然無聲	悄然無聲	悄無聲息	萬籟俱寂	靜寂	謐靜	幽篁	靜靜	幽僻	闃寂無聲	靜靜的	默默無語
荒涼	荒僻	荒	地廣人稀	人跡罕至	杳無人煙
淒涼	蒼涼	淒苦	蕭瑟	人去樓空	人亡物在	門庭冷落	清淒寂冷	淒厲	淒風冷雨
背	僻	冷僻	偏僻	荒僻	鄉僻	僻遠
冷落	冷清	冷清清	清冷	冷靜	蕭索	蕭條	蕭森	落寞	空蕩蕩	門可羅雀	無人問津	背靜	冷冷清清	滿目蒼涼	寞	無聲
孤單	孤	孤獨	孤寂	伶仃	寥寥	寂寂	隻身	一身	獨身	光杆兒	孤零零	孤苦伶仃	伶仃孤苦	形影相弔	形單影隻	孑然一身	孤家寡人	舉目無親	六親無靠	無依無靠	單槍匹馬	匹馬單槍	離群索居	孤立無援	顧影自憐	單人獨馬	孤單單	孤兒寡母	孤僻	孤身	孤身一人	孤孤單單	形影相對	孤苦伶丁
寂寞	落寞	寂寥	岑寂	枯寂	寂寂	孤寂	寥落	寂	眾叛親離	與世隔絕
繁忙	忙	忙於	忙碌	碌碌	無暇	不暇	應接不暇	起早摸黑	日不暇給	披星戴月	席不暇暖	跑跑顛顛	四處奔波	疲於奔命	心力交瘁	日理萬機	忙忙碌碌	東跑西顛	窘促	農忙	占線	大忙	纏身	沒空	忙不迭	百忙之中
匆忙	匆促	急促	急忙	匆匆	倉促	倉卒	皇皇	造次	倥傯	行色匆匆	匆匆忙忙	匆猝	急匆匆	急急忙忙	急三火四	一路風塵
空閒	悠閒	幽閒	安閒	清閒	輕閒	閒暇	空暇	閒空	悠然	閑	空	逸	暇	空餘	得空	有空	沒事
賦閑	休閒	優遊	閒適	閒散	恬淡	悠忽	悠悠忽忽	無所事事	優哉遊哉	清風明月	輪空	窮極無聊	閒心	閒雅	野鶴閑雲	悠然自得	賞月
舒服	舒坦	舒適	適	恬適	愜意	安適	適意	好過	甜美	寫意	舒展	安逸	養尊處優	舒舒服服	趁心	如坐春風	過癮	吃香的喝辣的
艱苦	艱辛	苦	辛苦	勞苦	辛勞	勞頓	勞瘁	勞碌	困苦	慘澹	千辛萬苦	風塵僕僕	僕僕風塵	篳路藍縷	餐風宿露	露宿風餐	風餐露宿	艱難竭蹶	飽經風霜	茹苦含辛	含辛茹苦	日曬雨淋	風吹雨打	櫛風沐雨	艱苦卓絕	拖兒帶女	辛辛苦苦	積勞成疾	堅苦卓絕	苦英英	累死累活	艱辛備嘗	風吹雨淋	餐風宿雪	困難重重
安全	安好	安然	無恙	平安	安	安康	康寧	一路平安	安然無恙	高枕無憂	別來無恙	平平安安	安如泰山	有驚無險
治安	有警必接
危險	危	懸	危急	危亡	危殆	懸乎	險惡	兇險	驚險	艱危	不濟事	險象環生	岌岌可危	千鈞一髮	一髮千鈞	不絕如縷	間不容髮	厝火積薪	救火揚沸	危如累卵	搖搖欲墜	盲人瞎馬	深入虎穴	朝不保夕	危在旦夕	生死攸關	生死存亡	魚游釜中	如臨深淵	如履薄冰	虎尾春冰	虎口拔牙	引狼入室	人人自危	飲鴆止渴	安危	危象	責任險	財險	奇險	危若累卵	高危	產險	驚險萬狀
大敵當前	腹背受敵	四面楚歌	危機四伏	彈盡糧絕	山窮水盡	自顧不暇	總危機	危及	危難	性命交關	經濟危機	刀山劍林	風急浪大	大難臨頭
幸福	福	甜	甜蜜	美滿	甜美	甜絲絲	洪福齊天	福如東海	人夀年豐	花好月圓	甜滋滋	甜甜的	甜蜜蜜
喜慶	喜	慶	大喜	吉慶	雙喜臨門
悲慘	淒慘	悽愴	悲涼	悲	淒涼	淒清	淒婉	慘痛	慘然	慘	慘不忍睹	傷心慘目	慘絕人寰	淒風楚雨	淒美	淒淒慘慘	無助	災難性	哀婉
滿目瘡痍	瘡痍滿目	寸草不留	十室九空	血肉橫飛	血流成河	腥風血雨	血雨腥風	赤地千里	家破人亡	妻離子散	生靈塗炭	雞犬不留	民不聊生	餓殍遍野	水深火熱	悲慘慘	家敗人亡	命苦	目不忍睹	貧病交加	哀鴻遍野
離合悲歡	悲歡
和緩	緩和	舒緩	弛緩	鬆弛	輕鬆	弛懈	輕裝	緩解	解乏
緊張	吃緊	白熱化	劍拔弩張	刀光劍影	如臨大敵	一觸即發	千鈞一髮	一髮千鈞	箭在弦上	驚心動魄	密鑼緊鼓	緊鑼密鼓	磨刀霍霍	風聲鶴唳	草木皆兵	山雨欲來風滿樓	動魄驚心	緊緊張張	緊缺	逼人	刀光血影	焦慮不安	僧多粥少
莊嚴	莊重	整肅	嚴肅	肅穆	尊嚴	謹嚴	嚴正	威嚴	儼然	盛大	儼
清潔	乾淨	衛生	整潔	清爽	清新	潔	淨	一塵不染	窗明几淨	明窗淨几	白淨淨	乾乾淨淨	潔淨	淨化	淨空	清爽爽	無污染	清清爽爽
骯髒	齷齪	邋遢	污濁	污穢	惡濁	渾濁	髒	汙	濁	穢	污染	髒乎乎	髒亂	滓	水污染	汙跡	髒亂差	印跡
蓬頭垢面	囚首垢面	衣冠不整
整齊	整	齊	整飭	齊整	嚴整	儼然	楚楚	齊楚	俐落	劃一	整齊劃一	停停當當	渾然一色	衣冠楚楚	整整的
井然	井然不紊	井然有序	井井有條	有條不紊	有條有理	有板有眼	整整齊齊	秩序井然	齊刷刷	錯落有致
雜亂	混亂	紊亂	紛亂	忙亂	淆亂	零亂	繚亂	錯亂	亂雜	繁雜	冗雜	混雜	錯雜	間雜	駁雜	拉雜	蕪雜	龐雜	狼藉	雜遝	糊塗	橫生	蓬亂	亂套	亂	爛	雜亂無章	雜七雜八	夾七夾八	亂七八糟	烏七八糟	紛紛揚揚	杯盤狼藉	背悔	眼花繚亂	拉拉雜雜	爛乎乎	撩亂	淩亂	不成方圓	紊	散亂	無規律
蓬鬆	枝蔓	紛	雜草叢生
一窩蜂	一鍋粥	一團糟	一團亂麻	亂成一團	一塌糊塗
亂糟糟	亂騰騰	亂紛紛	亂蓬蓬	亂哄哄	七嘴八舌	七手八腳	打亂	藉	失調	污七八糟
富裕	富有	有錢	殷實	富貴	趁錢	富足	富庶	豐足	富饒	豐饒	穰穰	豐盈	豐裕	豐厚	厚實	優裕	余裕	寬裕	充盈	紅火	富	寬	松	從容	方便	鬆動	活絡	寬綽	有餘	綽有餘裕	綽綽有餘	家給人足	豐衣足食	萬貫家財	腰纏萬貫	堆金積玉	金玉滿堂	榮華富貴	財大氣粗	富國	極富
小康	溫飽	過得去	好過	次貧	飽暖
貧窮	貧	窮	貧困	窮困	清貧	貧乏	窮乏	空乏	貧寒	清寒	寒苦	寒微	窮苦	貧苦	赤貧	清苦	貧賤	竭蹶	身無分文	特困	一窮二白	家無擔石	艱	老少邊窮	鞠	致貧	返貧
困難	艱難	艱苦	困苦	拮据	不便	不方便	窘迫	困頓	倥傯	孤苦	緊	窘	緊巴巴	鬧饑荒	清鍋冷灶	窮山惡水	窘困	手頭緊	真貧	千難萬險	諸多不便
身無長物	別無長物	兩手空空	囊空如洗	一貧如洗	一無所有	一文不名	不名一文	寅吃卯糧	缺衣少食	衣不蔽體	捉襟見肘	鶉衣百結	履穿踵決	糠菜半年糧	簞食瓢飲	並日而食	數米而炊	家徒四壁	債臺高築	饑寒交迫	貧病交迫	啼饑號寒	嗷嗷待哺	民窮財盡
打	擊	揍	擂	動手	打私
毒打	痛打	夯	強擊	猛打
敲打	打擊	鼓	叩	擊	敲	篩	擂	撾	鳴	敲敲打打	擂鼓	敲敲	敲門	敲擊	叩門	叩開	叩響	叩擊	戛
捶打	捶	搗	楔	釘	搗碎
砸	搗	敲響	敲開
拷打	拷	掠
抽打	鞭打	鞭笞	鞭撻	抽	鞭	笞
撲打	撲	踢打
磕打	摔打	磕	摔	摜	砸鍋賣鐵	砸爛	砸碎	打碎
打耳光	掌嘴	打嘴巴	耳刮子
還擊	還手	回擊	回手
拍	拊	撲	撣	拍拍
拍打	撲打
拍手	拍巴掌	鼓掌	拍掌	拊掌	擊掌	拍擊	缶掌	拍桌子
撫摩	摩挲	胡嚕	捋	撫摸	愛撫
搔	抓	撓	抓撓	扒	抓癢	撓搔	撓頭
摸	摸出	摸得著	摸摸	摩
拉	拉扯	扯	拽	掣	抻	挽	引	拉長	拉杆	拉開	直拉	拉纖	拉拉
推	排	揎	搡	排氣	推杆	推開	推向
拖	拖曳	牽引	牽	引	挽	拉	拖床	拖住	拉住	趿
扛	荷	掮	夯
挑	擔	挑水
抬	抬杠	扛	搭	舁	輿	抬扛	抬筐
背	馱	負	負重	背上
舉	擎	扛	打	舉起	挺舉
托	把	托舉	托起
高舉	揚	揭	揚起
振臂	攘臂
舉杯	把酒
捧	掬	端	端面	端平
撳	按	摁	按動	打傘
掐	扼	卡	捏
壓	擠壓	拶	按	扼住	壓彎
壓榨	榨	榨取
滾壓	軋	磨	碾	擀	推	砘	風壓	光壓	靜壓	脈壓	偏壓	氣壓	滲透壓	眼壓	液壓	油壓
撐	支	抵	頂	戧	支撐	撐篙	撐住	硬撐
拿	持	執	捉	秉	操	仗	手	握	攥	搦	持有	持球	緊握	手持	執棒	握緊	持械	持槍	拿出	握有
把握	把	握住	在握	把住
抓	綽	撈	攫	抓差	抓起	力抓	撈取
提	拎	提起
出具	出示
撮	拈
揪	扭	掀開
夾	挾	夾餡	裹挾
攙	扶	攙扶	扶掖	扶持	扶老攜幼	扶起	攜手	勾肩搭背
挽	牽	攜
抱	摟	攬	摟抱	擁抱	抱抱
合抱	合圍
拔	擢	搴	薅	拔節	自拔	拔掉	拔出
摘	采	採摘	採擷	摘取	摘發	采采	摘掉
剝	扒	揭	剝離	剖開	扒開
撕	扯	撕開	撕破	撕碎	撕下	摘除	撕裂
抽	掣
折	撅	拗	折斷	攀折	扭斷	折中	掰開
掰	劈	擗
挖	剜	掘	刨	摳	鑿	掏	扒	打	開	挖掘	開掘	發掘	開鑿	挖潛	鑽井	打通	打樁	掘進	掘開	開路	打井	開挖	挖沙
刳	掏空	洞開	挖出
剔	挑	撬	剔出
鉗	夾	搛
填	堵	堵塞	塞	楦	回填	填平	塞入	裝填	揣	裝滿	充填
埋	掩埋	埋藏	埋入
埋葬	葬	瘞	入土	崖葬	葬身	國葬
塞	掖	塞入
插	栽	簪	扡插	加塞兒	倒插	插隊	插入	安插
嵌	鑲	鑲嵌	藉	嵌鑲
襯	墊	襯裡	墊腳
放	擱	置	撂	厝	坐	搭	安放	放置	停放	留置	置於	放到	放開	前置	內置	置放	放權	平放	嵌入	措
豎立	立	戳	豎起
下	投	投放	撂下	施放	排放	置之腦後
堆	垛	碼	摞
疊	折	折疊	沁	佴	矗起
掛	吊	張	懸	懸掛	張掛	倒掛	高高掛起	鉤掛
鋪	攤	墁	鋪攤	席地	鋪開	鋪平
蓋	遮蓋	覆蓋	捂	瓦	苫	捂住	燾
掀	揭	撩	褰	掀起	擤	冪	撩開
捋	攘	揎
仍	擲	拋	摜	摔	投	甩	丟	拽	撇	投擲	拋擲	投射	扔掉	甩掉	空投	投標	投向	拋光	丟開	遠投	競投	投中	甩開	投球
接	承	承接	接球
拾	拾取	撿	擷拾	揀到	撿拾
鬆手	放手	撒手	失手
包	裹	包裹	包裝	封裝	打包	捲入	裝進	裹進
裝	盛	裝入	裝壇
卷	挽	窩	捲曲	卷起
捆	紮	縛	束	打	繒	襻	攏	絏	勒	箍	捆紮	包紮	捆綁	綁	牢系	綁紮	鬆綁
五花大綁	紅繩繫足	反轉
栓	拴
扣	系	紐
打結	系	綰
絞	擰	上	絞手
繞	絡
穿	穿著	著	服	衣	擐	上身	登	穿戴	穿上	穿衣	身穿	試穿
披掛	身披	披紅戴花
戴	冠
佩帶	佩	帶	別	佩戴	身著	著裝	安全帶	配戴
脫	褪	扒	下	卸	寬衣	鬆開	卸下	卸掉
脫帽	免冠	脫皮	掙脫
解	松	褪	解開	肢解
拆	拆除	拆毀	拆卸	拆開	拆遷	拆散	拆線	拆解
塗	塗飾	塗抹	擦	上	敷	搽	抹	刷	抿	抹煞	外敷	塗刷
糊	刮	抹	泥
貼	粘	膠	糊	粘貼	膠合	粘合	貼邊	貼補
裱	裱褙
洗	浣	滌	濯	澡	漱	湔	盥洗	清洗	洗滌	洗濯	滌蕩	滌除	漱口	洗潔	洗洗	保潔
洗澡	沐浴	沖涼	浴	擦澡	淋洗	洗浴
搓澡	搓洗
刷洗	洗刷
沖洗	沖
蕩	涮	漂
漿洗	漿	換洗	涮洗	洗煤	洗手	洗衣	漂洗	雪洗	淘洗
掃	掃除	打掃	除雪	掃雪
清掃	大掃除	灑掃	犁庭掃閭
擦	拭	揩	抹	抆	擀	拂	拂拭	擦	上漿	板擦	擦拭	抹掉	擦洗	擦屁股	拭淚	擦亮
磨	鋼	鐾	礪	砣	研	擂	錯	打磨	研磨	磨擦	磨刀	碾碎
揉	揉搓
撚	搓	撚子
撈	打撈	罱	捕撈	撈起
舀	打	挹	撇	掏
灌	注	灌溉	灌注	澆灌	倒灌	管灌	滴灌
汲	吸	戽	車	汲水
澆	淋	澆注
灑	潑	潲	撩	抛灑
沏	沖	泡	沏茶
斟	倒	篩	釃
篩	羅	淘	篩選
簸	揚	簸揚
濾	淋	漉	釃	過濾
攪拌	拌和	攪和	攪動	打	攪	拌	餷	洗
攙和	攙雜	攙	和	對
掭	膏	蘸
切	鍘	剄	劐	芟	釤	鏜
切片	片	切除	切開	切塊
削	修	剡	絞	旋	錛	切削
割	拉	刈	剌
剖	破	劃	鋸	劈	劈開
剪	推	鉸	裁	裁剪	剪裁	翦
修剪	修	修理	修枝	葺
刻	雕刻	雕	琢	契.
砍	斬	斫	剁	斫	伐	砍伐	採伐
亂砍濫伐	濫伐
伐樹	伐木
刮	刮削	批	搶	剃	刨
戳	捅	通	紮	穿	杵
刺	搠	攮
戳穿	剌	穿刺	穿孔
碰	觸	捅	動	觸動	動手	觸摸
翻	傾	倒	攉	翻騰	倒騰	掀翻	翻翻	倒入
傾倒	放
扇	鼓
撒	播	散	散步	播撒
開	打開	張開	啟	被	展	敞	敞開	拉開	啟封	翻開	開啟
關	關閉	閉	合	掩	闔	密閉	虛掩	關掉	閉合	封關	閉鎖
上鎖	鎖
搬動	挪動	移動	騰挪	移	搬	挪	移送
搖動	搖撼	撼動	擺動	晃動	搖	皇	擺	蕩	舞獅	搖頭	偏移	搖搖擺擺	擺擺	搖搖
扇動	振
抖動	抖摟	抖	甩	拂	擻
揮動	揮舞	舞動	舞弄	揮	舞	掄	晃	手搖	揮手
招手	招	擺手
撥動	扒拉	撥拉	撥	扒	撥開
扒	扒拉
扳動	扳	摟
擺弄	弄	調弄	撥弄	盤弄	搬弄	鼓搗	搗鼓
玩弄	戲弄	耍
揉	團
彈起	反彈
比畫	比	比試	打手勢	指手畫腳	比劃
指點	指畫	指	點	指指戳戳
袖手	揣手兒	抄手
握手	把手	抓手
走	行	步	履	躒	走動	走路	走道兒	行走	行動	行路	行進	步履	逯
拔腿	拔腳	舉步	邁步	邁開
止步	卻步	停步	站住	站住腳
步行	徒步	徒步走
闊步	縱步	大步	大步流星	齊步	齊步走
小步	碎步	蹀躞
快步	疾步	奔走	疾走	奔	趨	健步如飛	快步流星	三步並作兩步
慢走	踱	徐步	緩步	彳亍	鵝行鴨步	慢行	姍
散步	溜達	遛	逛	繞彎兒	遛彎兒	轉悠	轉轉	走走
漫步	信步	信馬由韁	穿行	閒庭信步
閒逛	遊逛	閒蕩	遊蕩	蕩	遊	徜徉	逛逛	倘佯
蹣跚	踉蹌	蹌踉	趔趄	趑趄	跌跌撞撞	磕磕絆絆	磕磕撞撞	一溜歪斜	踉踉蹌蹌	蹌	蹣
扭	折腰
徘徊	盤旋	低回	躑躅	蹀躞	回游	踱步
躡	溜
登高	登	陟	爬
躡手躡腳	輕手輕腳
大搖大擺	高視闊步
踏遍	走遍
跑	驅	奔	奔跑	跑步	小跑	奔走	顛	弛	騁	跑動
狂奔	飛奔	飛跑	奔命	奔向
馳騁	馳驅	馳驟	跑馬	奔騰	馳
飛馳	賓士	疾馳	飛車走壁	驤
跳	跳躍	騰躍	踴躍	雀躍	魚躍	躍進	躍	蹦	騰	躥	縱	縱身	縱步	躍動	彈跳
連跑帶跳	跑跑跳跳	撒歡兒	蹦蹦跳跳	虎躍龍騰
踢	踹	蹴	尥蹶子	踢蹬	踢打	蹬	蹬腿	蹬踏
踩	踏	登	踐	蹴	踹	蹈	踐踏	踏平	踏上
跺腳	跳腳	跺
踮	蹺
抬腳	起腳
坐	坐坐	坐下
端坐	正襟危坐
席地而坐	後坐
盤腿	趺坐	跏趺
打坐	入定	坐禪	坐定	坐功
入座	落座	就座	就坐
蹲	踞	猴
立	站
佇立	佇
直立	兀立	挺立	鵠立	立正	立定	重足而立
站穩	站住	站隊	站櫃臺	站立
起立	站起	謖
騎	跨	單騎	跨上	騎車
跨	邁	翻過	橫跨	橫亙	跨步	邁出	跨過
越	翻	翻越	騰越	翻翻
抬頭	昂首	翹首	昂起	仰頭
低頭	垂頭	俯首
回頭	回首	掉頭	轉臉	扭頭
點頭	頷首	首肯	點點頭
睜眼	張目	開眼	睜
瞪眼	瞪	瞠目
閉眼	合眼	閉目
眯眼	眯縫	眯	餳	覷
眨眼	眨巴	忽閃	閃動	眨
飛眼	使眼色	遞眼色	擠眉弄眼
皺眉	皺眉頭	蹙眉	顰	愁眉不展	皺眉
撅嘴	努嘴	撇嘴
接吻	親吻	親嘴	吻	親
看	瞧	瞅	視	觀	覽	相	盼	顧	張	望	覷	目	睃	探望	觀望	觀看	收看	察看	見到	走著瞧	見狀	見兔顧犬	來看	總的來看	看出	看到	看來	看齊	看樣子	觀展	觀覽	看看	見見	闞
注視	凝視	凝眸	凝望	矚望	注目	矚目	目送	定睛	逼視	盯	瞄	睽睽	目不轉睛	只見	直盯盯	盯住
端詳	端量	細看	審視	矚	瞻	審美
展望	瞻望	遙望	遠望	登高望遠	望去	望望
瞭望	眺望	守望	遠眺	憑眺	眺	極目眺望	極目遠眺
環視	掃視	環顧	圍觀	掃描	舉目四望
鳥瞰	俯瞰	俯視	盡收眼底
仰望	仰視	舉目	瞻仰	仰天
張望	顧盼	東張西望	左顧右盼
回眸	回顧	反顧	回望	反觀
極目	縱目	騁目	放眼	縱覽	縱觀	一覽	一覽無餘	統觀	概覽
正視	目不斜視	令人注目	面對面
斜視	乜斜	側目	瞟	眄
怒視	瞪	怒目而視	側目而視
對視	目視	平視	相望	隔海相望
窺探	窺見	窺視	窺	偷眼	偷看	覘	探頭探腦	窺測	窺伺	斑豹一窺	偷窺
瞥	掃	睨
白眼	白	乜
流覽	溜	采風	參觀	覽勝
看見	瞧見	望見	瞅見	瞥見	見	睹	觸目	映入眼簾	盡收眼底	眼見	瞧瞧	細瞧
目睹	目擊	目見	親見	馬首是瞻	略見一斑	觀禮	觀摩	觀戰	親眼見	親眼目睹	耳聞目見
望風	把風	觀風	巡風
一窺全豹	一斑窺豹	以小見大
看起來	看上去
聽	收聽	聽取	聽聽
傾聽	聆聽	聆取	聆	洗耳恭聽	靜聽	諦聽
偷聽	竊聽	屬垣有耳	隔牆有耳
聽見	聞	聰	視聽	聽到
聽說	耳聞	傳聞	風聞	聞訊	時有所聞	聽講	親聞
嗅	聞	難聞
聞到	嗅到
吃	食	茹	餐	動	用	啖	服	偏	零吃	民以食為天	吃請	吃掉
攝食	吃光	飽餐
內服	口服
啄	塞	饢	填	狼吞虎嚥	塞入
嚼	咀嚼	噍
咽	噲	吞	吞食	吞服	沖服	服藥	服用	咽下	吞咽
吮	吸吮	吮吸	吸食	吸	嗍	嘬	裹	咂	吮吸	茹毛飲血	吸入
喝	飲	呷	啜	抿
喝酒	飲酒	喝
豪飲	狂飲	酣飲	暢飲	痛飲	飲水	飲用
酗酒	縱酒
飲茶	喝茶
叼	含	銜	噙
舔	舐
咬	噬	磕	啃	齧	咋	嗑	咬牙
叮	螫
呼	哈	呵	噓	吹
送氣	噓氣
吐	唾	啐
噴	噴氣	噴吐	噴雲吐霧
吸	抽	吧	吧嗒	吧唧	空吸	吸附	吸氣	吸煙	抽煙
呼吸	透氣	深呼吸	四呼	人工呼吸
做聲	發音	失聲	聲張	嚷嚷	發聲
呻吟	哼	打呼	哼哼
吧嗒	吧唧	咂嘴
呼喚	呼	喚	叫	招呼	傳喚
吹口哨	打口哨	嘯	呼哨	口哨
喊	呼	喝	嚎	嚷	喊叫	叫喊	呼喊	呐喊	叫嚷	吵嚷	喧嚷	呼號	叫號	喊話	叫喚	嘖	疾呼
大叫	號叫	高喊	高呼	大喊大叫	大聲疾呼	大喊	呼叫	人聲鼎沸	驚呼	驚叫	喝六呼麼	吼三喝四
吆喝	咋呼	叱喝	喝	呼么喝六	當頭棒喝	吆
吼	咆哮	怒吼
歡呼	喝彩	吹呼	滿堂喝彩
喝倒彩	噓	倒彩
哀鳴	哀號	悲鳴	嘶叫	四呼	吒	唳	嗷嗷叫	哀嚎	哀呼	哀叫	嚎啕
叫	鳴	啼	哨	噪	囀	打鳴兒	鳴叫	吠形吠聲
吼叫	吼	嘯	吟	嗥	嚎	啼	嘶	吠	咬	空喊	狂吠	狂呼	虎嘯	長嘯
飛	飛翔	翱翔	回翔	翥	展翅	翱	翔	翩	羿	頡
高舉	飛騰
翻飛	翩翩
蠕動	蠕蠕	咕容	蠢動	蠕
傾	傾斜	歪斜	打斜	斜	歪	側
靠	倚	憑	倚靠	掛靠
偎	偎依	依偎
躺	臥	睡	橫躺豎臥
躺下	臥倒	躺倒
仰臥	平臥
靜臥	安臥
趴	臥	撲	伏	俯伏	趴下
彎腰	哈腰	折腰	躬身
欠身	欠
伸腰	伸懶腰
蜷曲	蜷	弓	蜷縮	蜷伏
前仰後合	前俯後仰
打滑	滑	溜	出溜
跌倒	摔倒	栽倒	栽	絆倒
跌跤	摔交	栽跟頭	摔跟頭	栽斤頭	跤
僕	踣	狗吃屎
失腳	失足
打前失	馬失前蹄
發抖	顫抖	戰抖	抖	寒戰	顫慄	哆嗦	篩糠	打哆嗦	戰戰兢兢	打冷顫	寒顫	寒噤	顫	打顫	戰慄
顫悠悠	顫顫巍巍
打滾	翻滾
倒立	拿大頂
翻跟頭	滾翻
跟頭	斤斗
翻身	輾轉	折騰	翻來覆去	輾轉反側	輾
爬	爬行	匍匐
蜿蜒	蛇行
爬山	登山	爬山越嶺
攀	爬	攀登	登攀	攀緣	攀援
鑽	鑽進	潛入	紮
沖	闖	撞	撲	衝突	衝開
奔突	狼奔豕突	橫衝直撞	猛撲	瞎闖	猛衝
擠	擠擠
行禮	敬禮	施禮	有禮	致敬
鞠躬	折腰	哈腰	唱喏	打躬作揖
襝衽	拜拜	萬福	福
還禮	回禮
下跪	跪	屈膝	長跪	跪倒	跪下
磕頭	叩頭	叩首	跪拜	叩	拜	頓首	稽首	厥
膜拜	頂禮膜拜
高興	開心	愉快	歡快	稱快	快活	快樂	歡樂	歡娛	歡愉	歡欣	歡喜	喜歡	欣喜	欣然	怡然	陶然	愉悅	融融	樂意	樂	歡	喜	快	欣	怡	樂陶陶	樂滋滋	樂呵呵	樂悠悠	樂融融	喜衝衝	喜滋滋	喜洋洋	喜氣洋洋	興沖沖	甜絲絲	美絲絲	美滋滋	歡欣鼓舞	賞心悅目	如獲至寶	僖	高高興興	逸樂	欣悅	悅	欣欣然	快快樂樂	歡歡喜喜	歡悅	喜悅	先睹為快	其樂融融	撒歡	暗喜	為之一喜	愷
狂喜	銷魂	歡天喜地	欣喜若狂	喜出望外	大喜過望	興高采烈	樂不可支	其樂無窮	心花怒放	不亦樂乎	得意洋洋	合不攏嘴	驚喜萬分
開顏	喜形於色	眉飛色舞	春風滿面	滿面春風	喜上眉梢	歡顏	喜不自勝	喜笑顏開	歡眉喜眼	興高彩烈
歡騰	歡躍	手舞足蹈	歡呼雀躍
欣幸	慶倖	幸喜	幸甚	慶	拍手稱快	大快人心	皆大歡喜	喜從天降	額手稱慶	和樂	可賀
悲喜交集	驚喜交集	又驚又喜	轉悲為喜	驚喜	大悲大喜	悲喜	喜怒哀樂
悲傷	傷悲	傷心	傷感	熬心	難過	難受	悲	哀	哀傷	悲哀	悲戚	悲愁	哀愁	哀戚	悲愴	憂傷	淒然	悽愴	淒惻	悽惶	殷殷	不是味兒	如喪考妣	淒風楚雨	同悲	可悲	不好過
悲痛	哀痛	沉痛	痛	痛心	悲憤	痛切	悲切	斷腸	肝腸寸斷	黯然銷魂	長歌當哭	椎心泣血	痛定思痛	人琴俱亡	不堪回首	五內俱裂	悲痛欲絕	痛不欲生	萬箭穿心	欲哭無淚	悲慟	悲傷欲絕	悲壯	叫苦連天
痛苦	痛	苦痛	慘痛	傷痛	慘然	悲苦	心如刀割	黯然神傷	纏綿悱惻	切膚之痛	睹物傷情
辛酸	酸辛	心酸	酸溜溜	苦澀	寒心
淒慘	悽楚	淒切	淒淒慘慘
兔死狐悲	物傷其類
憂愁	發愁	犯愁	憂	愁	憂傷	悄然	憂思	憂心忡忡	憂心如焚	心事重重	愁眉不展	愁眉鎖眼	愁腸百結	鬱鬱寡歡	悲天憫人	愁思	背包袱
憂慮	焦慮	慮	憂患	擔憂	憂懼	堪憂	令人堪憂	令人擔憂
憂悶	愁悶	愁苦	憂鬱	抑鬱	陰鬱	鬱結	憂憤	悒悒	怏怏	鬱鬱不樂	悶悶不樂	忽忽不樂	怏怏不樂	氣悶	憂困	抑鬱寡歡
過慮	杞人憂天	庸人自擾
煩悶	煩心	糟心	煩亂	煩躁	煩惱	煩擾	憂悶	沉悶	苦悶	鬱悶	愁悶	憋悶	悶氣	憋氣	窩囊	不快	憋	堵	煩	悶	苦惱	抑鬱	鬱悒	沉鬱	窩心	憤懣	煩雜	坐臥不安	懣	苦於	懊惱	悶悶地	心煩	心煩意躁	煩憂	窩火	鬧心	憤悶
憋屈	委屈
憤怒	惱怒	含怒	氣惱	氣憤	義憤	激憤	憤激	憤慨	憤然	憤憤	悻悻	慍	恚	怒	氣	惱	憤	怒衝衝	氣衝衝	氣乎乎	氣鼓鼓	惱羞成怒	怒氣衝衝	怒氣攻心	氣哼哼	懣	怒目橫眉	忿	慨	氣呼呼	憤悶	生悶氣	一怒之下
惹氣	慪氣	賭氣	負氣	慪	惹惱	可氣
動火	動肝火	惱火	冒火	光火	發火	上火	掛火	動怒	發怒	生氣	動氣	火	炸	攛	嗔	發毛	發狠	紅臉	眼紅	紅眼	變色	作色	發作	發脾氣	鬧脾氣	使性子	耍態度	怒形於色	疾言厲色	直眉瞪眼	橫眉豎眼	七竅生煙	臉紅脖子粗	拂袖而去	黑下臉	不悅	一氣之下
震怒	盛怒	怒火中燒	火冒三丈	赫然而怒	怒不可遏	勃然大怒	大發雷霆	暴跳如雷	怒氣衝天	令人髮指	怒髮衝冠	氣沖牛斗	義憤填膺	悲憤填膺	天怒人怨	老羞成怒	怒目圓睜	捶胸頓足
洩恨	洩憤	出氣	撒氣	遷怒	泄私憤
息怒	消氣	解氣	解恨
得意	抖	美	飄飄然	怡然自得	揚揚得意	揚眉吐氣	自鳴得意	春風得意	揚揚自得	自得其樂	沾沾自喜	自我欣賞	搖頭晃腦	搖頭擺尾	躊躇滿志	得意忘形	顧盼自雄	吐氣揚眉	志得意滿
惆悵	悵惘	惘然	悵	忽忽	忽忽不樂	惘然若失	若有所失	悵然若失	迷惘	悵然
失意	向隅
灰心	喪氣	洩氣	洩勁	氣短	氣餒	自餒	涼	懊喪	沮喪	灰溜溜	心灰意懶	灰心喪氣	垂頭喪氣	心如死灰	槁木死灰	萬念俱灰	心灰意冷	蔫頭耷腦	心寒	寒心
消沉	低沉	黯然	感傷
頹喪	頹廢	頹敗	頹靡	頹然	頹唐	委靡	累累	萎靡不振	頹	委靡不振
失望	大失所望
掃興	敗興	殺風景	大煞風景	煞風景
計畫	籌畫	規劃	擘畫	籌算	籌	統籌	設計	宏圖	計劃性	企劃
籌措	運籌	運籌帷幄	統攬全域
策劃	謀劃	計謀	圖謀	謀劃	圖	企圖	深謀遠慮	策動	要圖	異圖	廣謀從眾
打算	算計	計算	盤算	準備	計較	試圖	待	擬	計	打小算盤	意欲	刻劃	精算	人有千算
滿意	愜意	樂意	中意	合意	可意	遂意	如意	稱意	遂心	稱心	可心	順心	對眼	稱願	好聽	遂心如意	稱心如意	如願以償	心滿意足	正中下懷	差強人意	深孚眾望	看中	令人滿意
滿足	知足	滿	償	知足常樂
舒暢	寬暢	酣暢	歡暢	暢快	痛快	清爽	爽快	鬆快	好受	好過	得勁	是味兒	舒服	舒適	舒心	快意	適意	痛快淋漓	心曠神怡	賞心悅目	揚眉吐氣	痛痛快快	吐氣揚眉	飄飄欲仙	如沐春風	如坐春風	如沐春雨
輕鬆	自在	優哉遊哉	逍遙自在	清閒自在	自由自在	輕輕鬆松
暢	敞	酣	盡興	開懷	騁懷	敞開
不滿	遺憾	缺憾	不盡人意	深懷不滿	一瓶子不滿
不平	鳴不平	抱不平	忿忿不平	不平則鳴	鳴冤叫屈
心安	安心	安詳	安然	安	慰	安慰	快慰	欣慰	寬慰	告慰	心安理得
自慰	聊以自慰	聊以解嘲	望梅止渴	畫餅充饑
瞑目	九泉瞑目	含笑九泉
不安	緊張	亂	煩亂	浮動	打鼓	疚	食不甘味	心事重重	心煩意亂	心慌意亂	心亂如麻	方寸已亂	心神不定	若有所失	六神無主	神魂顛倒	魂不守舍	魂不附體	坐立不安	坐臥不寧	惶恐不安	惴惴不安	誠惶誠恐	七上八下	忐忑不安	如坐針氈	芒刺在背	惶惶不可終日	緊緊張張	令人不安	寢食難安	心神不安	寢食不安	惴惴	仄	忐忑
慚愧	羞愧	羞慚	愧怍	慚	愧	忝	恥	羞	恧	汗顏	愧赧	愧恨	問心有愧	自慚形穢	無地自容
難為情	不好意思	過意不去	不過意
抱歉	抱愧	負疚	內疚	愧疚	歉疚	歉	有愧	愧對
心虛	虛	虧心	做賊心虛	心中有鬼	昧心
無愧	不愧	硬氣	對得起	對得住	理直氣壯	心安理得	問心無愧	當之無愧	無愧於	不愧為
鎮靜	沉著	鎮定	沉住氣	行若無事	若無其事	措置裕如	處之泰然	泰然處之	泰然自若	談笑自若	滿不在乎	不動聲色	面不改色	寵辱不驚	穩如泰山	鎮定自若	熙和恬靜	波瀾不驚	守靜	處變不驚	定神	毫不動搖	見慣不驚
從容	不慌不忙	從容不迫	好整以暇	不慌不亂	從從容容
心靜	平靜	安靜	寧靜	恬靜	熨帖	坦然	安然	釋然	恬然	平心靜氣	心平氣和	安安靜靜	沉心靜氣	少安毋躁
安穩	落實	塌實	篤定
慌張	發慌	著慌	心慌	驚慌	驚惶	發毛	張惶	倉皇	惶遽	慌亂	慌	毛	慌手慌腳	手忙腳亂	心慌意亂	不知所措	張惶失措	手足無措	無所措手足	驚慌失措	失魂落魄	驚魂未定	心驚肉跳	自相驚擾	慌慌張張	慌裡慌張	恐慌	無所適從	斷線風箏	沒著沒落	多躁少靜	遑	倉惶	大呼小叫	虛驚	受寵若驚	大題小做
著急	焦急	心急	發急	焦心	心焦	焦躁	焦灼	焦炙	著忙	慌忙	急忙	匆忙	要緊	急	急急巴巴	氣急敗壞	迫不及待	急如星火	心急如火	心急如焚	心急火燎	火燒火燎	心切	油煎火燎	急茬	乾著急	急火火	急急	狗急跳牆
急切	迫切	亟	如饑如渴	饑不擇食	急功近利	急於求成	歸心似箭	急不可待	急不可耐	急於	亟待解決	情急
殷切	殷殷	恨鐵不成鋼	如饑似渴
決意	決心	決計	決定	立意	定弦	銳意	狠心	下狠心	鐵心	發狠	立志	矢志	發誓	誓	咬緊牙關	痛下決心	厲害	了得
猶豫	猶疑	遲疑	踟躕	躊躇	動搖	徘徊	趑趄	瞻顧	瞻前顧後	猶豫不決	踟躕不前	趑趄不前	裹足不前	優柔寡斷	狐疑不決	遲疑不決	沉吟不決	舉棋不定	欲言又止	首鼠兩端	猶猶豫豫	猶豫不前	躊躇不前	當斷不斷	遊移	彷徨	支支吾吾
三心二意	見異思遷	朝三暮四	朝令夕改	朝秦暮楚
無奈	無可奈何	百般無奈	不得已	迫不得已	萬不得已	沒法	沒奈何	有心無力	萬般無奈	迫於	遠水解不了近渴	可望而不可及
奈何	無奈何	奈
無法	沒轍	沒門兒	無計可施	束手無策	別無良策	一籌莫展	黔驢技窮	力不從心	力不勝任	舉鼎絕臏	無能為力	心餘力絀	心有餘而力不足	獨木難支	孤掌難鳴	望洋興嘆	愛莫能助	鞭長莫及	回天乏術	獨木不成林	黔驢之技	無從	沒門	沒法兒	無力回天
山窮水盡	日暮途窮	束手待斃	坐以待斃	聽天由命	死路一條	在劫難逃
被迫	逼上梁山
抓瞎	抓耳撓腮	無從下手
難堪	好看	尷尬	為難	礙難
警惕	警覺	戒	當心	小心	居安思危	安不忘危	常備不懈	警醒	不容忽視
麻痹	鬆懈	鬆弛	鬆散	渙散	疲塌	麻痹大意	麻木不仁	高枕無憂	高枕而臥	鬆馳	痹	一盤散沙
疏忽	大意	忽視	忽略	失神	疏失	失慎	不注意	不經意	不在意	大意失荊州	千慮一失	在所不計
專心	悉心	潛心	入神	凝神	一心一意	全心全意	專心一志	專心致志	心無二用	聚精會神	全神貫注	凝神專注	心馳神往	專一	一門心思	一心	全身心	直視
分心	心不在焉	心猿意馬	魂不守舍
沉迷	著迷	入迷	癡迷	迷戀	入魔	著魔	沉湎	沉溺	熱中	迷	癡	耽	眩	癡心妄想	神魂顛倒	鬼迷心竅	樂此不疲	樂而忘返	樂不思蜀
陶醉	心醉	沉醉	醉心	如癡如醉	如醉如癡	如醉如狂	顛狂	自我陶醉	迷住	癡心
迷惑	迷惑	疑惑	一葉障目	迷惑不解	納悶	困惑	何去何從	難以名狀	迷離
留戀	貪戀	眷戀	依戀	懷戀	戀	流連	依依	低回	依依不捨	戀戀不捨	安土重遷	留連忘返	依依戀戀	思戀	戀家	戀春
習慣	慣	習以為常	吃得來	習慣於
上癮	成癮	成癖	嗜痂成癖
吃不服	吃不來
醒悟	覺悟	省悟	憬悟	覺醒	清醒	醒	如夢初醒	大夢初醒	醍醐灌頂	恍然大悟	迷途知返	敗子回頭	如夢方醒	猛醒	幡然醒悟	頓悟	頓覺	感悟	摸門兒	醒來
懂事	記事兒	開竅	通竅	覺世
驚奇	奇怪	驚異	詫異	奇異	駭異	納罕	希罕	咋舌	驚訝	驚詫	駭怪	怪	異	奇	詫	驚愕	愕然	駭然	大驚小怪	訝異	驚呆	驚歎	嘆觀止矣	好奇
害怕	懼怕	生怕	怕	生恐	畏怯	畏懼	恐懼	疑懼	恐怖	膽寒	忌憚	畏葸	惶惑	失色	咋舌	喪膽	憚	懼	畏	怖	亡魂喪膽	聞風喪膽	喪魂落魄	魂不附體	魂飛魄散	魄散魂飛	戰戰兢兢	驚心掉膽	毛骨悚然	提心吊膽	膽顫心驚	心驚膽顫	心驚肉跳	心膽俱裂	不寒而慄	噤若寒蟬	驚恐萬狀	大驚失色	面如土色	面無人色	視為畏途	望而生畏	望而卻步	人心惶惶	擔驚受怕	膽破心驚	膽戰心驚	心驚膽戰	懸心吊膽	令人心悸	悚	懾
憂懼	嚇壞	怔	心驚	怵	屁滾尿流	只怕	惟恐	令人生畏
後怕	餘悸	心有餘悸	談虎色變	三怕
驚恐	惶恐	驚駭	怔忪	惶惶	驚惶失措	驚恐萬狀	杯弓蛇影	風聲鶴唳	草木皆兵	如臨大敵	惶惶不可終日	不可終日	驚弓之鳥	驚懼	面無血色
受驚	吃驚	震驚	震	驚	大吃一驚	惶惶然
畏縮	畏忌	退避	發怵	縮頭縮腦	畏首畏尾	退避三舍	畏縮不前	畏難	畏罪
怕生	認生	怕人
怯場	怯陣
敬畏	敬而遠之
激動	衝動	興奮	心潮澎湃	百感交集	激動人心	心潮難平	激動不已	心潮起伏	令人鼓舞	催人奮進	氣盛	昂奮	扼腕
興致勃勃	津津有味
感動	感	觸	動容	感觸	百感叢生	催人淚下	令人感動	動感情	動人心魄
觸動	動心	觸景生情	即景生情	見獵心喜
感激	紉	領情	感激涕零	謝天謝地	感同身受	感激不盡
感恩	感恩戴德	感恩圖報	結草銜環	買帳
想像	設想	想像
空想	玄想	懸想	幻想	白日做夢	胡思亂想	想入非非	癡心妄想	異想天開	臆想	奇想
思考	思量	忖量	思忖	思慮	思索	思維	思想	考慮	盤算	合計	尋味	揣摩	琢磨	慮	想	思	構思	沉思	尋思	動腦筋	想想	思謀	默想	酌量	邏輯思維	思辨	心想	沉凝
浮想聯翩	心血來潮	思潮起伏	思潮澎湃	心潮澎湃	心潮翻騰	浮思翩翩	思緒萬千
幽思	深思	三思	熟思	深思熟慮	前思後想	思前想後	思來想去	靜思	靜心思過	發人深思	若有所思	思來想去
冥想	凝思	苦思冥想	冥思苦索	搜腸刮肚	苦思	冥思苦想
盡心竭力	煞費苦心	絞盡腦汁	搜索枯腸	挖空心思	處心積慮	嘔心瀝血	費盡心機	窮竭心計
苦心	刻意	著意	加意
設法	想法	變法兒	打主意	拿主意	千方百計	想方設法	靈機一動	急中生智	想盡
隨想	隨感	有感於
悟出	想開	想到	思悟	體悟
斟酌	酌	參酌	揣摩	琢磨	衡量	掂量	醞釀	研究	酌定	酌情
著想	設想	考慮
存心	居心	懷抱	心懷	胸懷	懷	抱	負	安	含	飲	煞費心機
感到	感覺	覺得	感	覺	發	深感	痛感	感覺到	倍感	備感
發覺	發現
認為	以為	覺得	道	看	當	覺著
主張	主持	主	力主	看好	著眼於
堅持	執	堅持不懈	堅稱	硬挺	咬牙
推測	揣測	忖度	揣度	推度	測度	推想	想來	想見	推理	推求	推斷	推論	度	想	揆	揆度	以己度人	測算	審度	揣摸	由此可知
臆斷	臆測	臆	臆想
因小見大	嘗鼎一臠
估計	估量	打量	估摸	估	量	忖	忖量	忖度	度德量力	審時度勢	估價	估算	估估	估斤算兩
猜想	猜測	猜度	猜謎兒	捉摸	懷疑	猜測	蒙	猜	自忖	猜猜	競猜
預料	逆料	意想	料想	預想	預期	料	諒	虞	意料
料到	料及	承望	試想
預測	預計	展望	前瞻	預後
希望	企望	盼望	祈望	祈望	期望	巴望	指望	仰望	想望	矚望	期待	夢想	願意	企盼	希	望	盼	期	祈	企	巴	欲	要	禱	想	幸	冀	可望	冀望	但願	意在	只求	務期
渴望	熱望	切盼	翹企	眼巴巴	巴不得	企足而待	望眼欲穿	望穿秋水	夢寐以求	霓	望子成龍	恨鐵不成鋼	翹首以待	渴盼	亟盼	期盼	望子成才	求知若渴	嗜書如渴	求賢若渴	急待	大旱望雲霓	恨不得	求之不得
嚮往	神往	憧憬
祈求	企求	希冀	希圖	覬覦	貪圖	圖	眼熱	熱中
要求	渴求	務求	求	講求
求得	邀
求全	苛求	求全責備
追求	探求	追逐	求	貪	幹	射	力求	孜孜追求	奔頭
謀求	謀	營	尋求
回憶	追憶	憶	回首	回顧	後顧	回溯	回想	追想	緬想	憶苦思甜	重溫舊夢	想起	撫今追昔	追思	遙想	溯	溫故知新	憶起
懷念	思念	想念	惦念	惦記	眷念	紀念	叨念	感念	顧念	感懷	懷想	思慕	思量	懷戀	眷戀	懷念	想	思	相思	朝思暮想	觸景傷情
深思	渴念	寤寐思之	一日三秋
思鄉	鄉思	故土難移
念舊	懷舊	懷古	憶舊	戀舊
悼念	追悼	哀悼	悲悼	傷逝	悼	哀	挽	人亡物在	睹物思人	人琴俱亡	痛悼	憑弔	緬懷	志哀	憂念
掛念	懸念	繫念	掛慮	掛心	記掛	牽掛	掛牽	掛懷	惦	掛	牽腸掛肚	惦掛	魂牽夢繫	魂牽夢縈	掛記
記得	記	記憶	飲水思源
記住	記取	切記	牢記	銘記	言猶在耳	記憶猶新	念念不忘	永志不忘	沒齒不忘	念茲在茲	刻骨銘心	銘心刻骨	銘肌鏤骨	刻肌刻骨	銘刻	難忘	難以忘懷	銘記在心	耿耿不忘	紀事	揮之不去	耿耿於懷	魂牽夢繞
介意	在心	在意
忘記	忘掉	忘卻	忘懷	遺忘	忘	置於腦後	淡忘	數典忘祖	忘本	記不清	丟三忘四
瞭解	理解	懂得	知道	曉得	明白	了了	領略	領悟	清楚	了然	明瞭	明亮	解	懂	曉	知	詳	喻	明	亮	知情	知底	接頭	敞亮	透亮	亮堂	分曉	掌握	知曉	未卜先知	冷暖自知，心明如鏡	時有所聞	寬解	略知一二	察察為明	辯明
有底	有數	心中有數	胸中有數	胸有成竹	成竹在胸
看透	看穿	看清	洞察	洞悉	瞭若指掌	一目了然	洞燭其奸	知己知彼	明察秋毫	吃透	窺破	偵破
覺察	察覺	發覺	發現	窺見	意識
知悉	悉
明知	明理	深明大義
探悉	獲悉	獲知	得知	摸清	意識到	識破	查出	查獲	深知	得悉	驚悉
熟悉	熟稔	稔知	熟諳	熟識	習	駕輕就熟	輕車熟路	如數家珍	知根知底	稔熟	耳熟能詳	深諳	知彼知己
貫通	精通	通曉	洞曉	曉暢	通	諳	貫	會	融會貫通	相通	一通百通
頓開茅塞	茅塞頓開	豁然開朗
路人皆知	人所共知	鮮為人知
懂法	知法
認識	認得	認	識
相識	相知	謀面
體會	體味	吟味	回味	咀嚼	認知
領會	理會	意會	領悟	會心	會意	心領	悟	心領神會	心照不宣
不解	不詳	茫然	發蒙	不清楚	不摸頭	沒譜兒	心中無數	一無所知	不甚了了	不得要領	霧裡看花	大惑不解	茫然不解	未知	天知道	不知所終	不為人知	渾然不知	琢磨不透	茫然無措	茫茫然	不明不白
一知半解	似懂非懂	知之甚少
誤會	誤解
喜歡	喜愛	喜好	歡喜	愛慕	愛好	欣賞	希罕	好	愛	喜	嗜	耽	愛不釋手	喜性
愛	喜愛	憐愛	心愛	鍾愛	友愛	熱愛	疼愛	酷愛	疼	慈	愛慕	老牛舐犢	摯愛	熱衷	愛護
戀	愛戀	熱戀	戀愛	戀情
溺愛	偏愛	寵愛	寵倖	寵	幸	嬌	嬌慣	慣	寵壞	偏好
傾心	動情	鍾情	懷春	一往情深	一見鍾情	為之動容	情有獨鍾	一見傾心	愛上	看上	忠於
相好	相愛	兩小無猜
敬業愛崗	敬業
愛民如子	愛國	愛民	愛教
討厭	厭惡	嫌惡	憎惡	痛惡	惡	厭	憎	嫌	煩	厭煩	膩煩	膩味	膩	頭痛	作嘔	倒胃口	深惡痛絕	疾首蹙額	掩鼻而過	看不順眼	看不慣
嫌棄	厭棄
厭倦	倦
厭世	厭戰
恨	怨	怨恨	怨艾	惱恨	恨死
仇視	仇恨	憎恨	憎惡	疾	交惡	反目成仇	狹路相逢	反目為仇	嫉恨	忌恨	結仇	會厭	夙嫌	親痛仇快
懷恨	記恨	抱恨	抱恨終天	記仇
憤恨	痛恨	切齒痛恨	咬牙切齒	恨之入骨	恨入骨髓	痛心疾首	疾惡如仇	同仇敵愾	不共戴天	憤世嫉俗	敵愾同仇
責怪	怪罪	見怪	嗔怪	嗔	怪
埋怨	抱怨	怨聲載道	民怨沸騰	天怒人怨	埋三怨四	怨天尤人	叫苦不迭
自咎	引咎	引咎自責
抱屈	抱委屈	鬧情緒	委屈	錯怪
尊敬	崇敬	敬重	敬愛	尊崇	尊	敬	禮賢下士	起敬	悌	敬意
敬仰	景仰	宗仰	仰慕	敬慕	景慕	慕名	心儀	想望	嚮往	仰
崇尚	崇	尚	奉若神明	敬若神明
相敬如賓	舉案齊眉
令人欽佩	可敬	可親可敬
尊師	尊老愛幼
佩服	敬佩	欽佩	贊佩	佩	畏	崇拜	悅服	嘆服	傾	傾倒	肅然起敬	心悅誠服	五體投地	令人嘆服
信服	服氣	心服	折服	服	認	伏	買帳	心服口服	口服心服
認輸	服輸	甘拜下風
不服	要強
羡慕	慕	愛慕	欣羡	豔羨	稱羨	嘆羨	眼饞	眼熱	眼紅	紅眼	令人羡慕	驚羨	羨	欽羨
妒忌	忌妒	嫉妒	吃醋	嫉	妒	酸溜溜	爭風吃醋	妒賢嫉能	嫉賢妒能	妒嫉
相信	憑信	置信	信	令人信服	信得過	諶
確信	堅信	無庸置疑	確乎不拔	可操左券	堅信不疑	毫無疑義
輕信	聽信	見風是雨	貴耳賤目	偏信
當真	認真	信以為真
自信	滿懷信心	志在必得
信仰	信奉	崇奉	篤信	迷信	皈依	奉	信	皈	信教	歸依
懷疑	狐疑	嫌疑	生疑	起疑	猜疑	疑心	疑慮	猜忌	多心	多疑	嘀咕	打結	疑	疑神疑鬼	疑心生暗鬼	存疑	信不過	犯嘀咕	難以置信
將信將疑	半信半疑
信任	相信	寵信	信賴	信從	親信	言聽計從	用人不疑	深信不疑	深信
贊成	贊同	同情	傾向	支持	眾口一辭
同意	認可	可以	首肯	可	認同感	也好	可不	仝
擁護	擁	擁戴	愛戴	深得民心	民心所向	匡扶
擁軍	擁軍優屬	雙擁
反對	不敢苟同	不以為然	不依	唱反調	唱對臺戲	不予
忍耐	忍	耐	忍受	容忍	隱忍	飲恨	忍氣吞聲	逆來順受	含垢忍辱	忍耐力	控制力	耐受
克制	抑制	控制	自製	自持	抑止	壓抑	按壓	按捺	按	捺	壓	平	憋	止	克	克服	相生相剋	相依相克
約束	收束	收	律己	自控
禁不住	撐不住	忍不住	不禁	不由得	不禁不由	身不由己	不由自主	情不自禁	經不住	難以忍受	按捺不住
可惜	惋惜	痛惜	嘆惜	歎惋	心疼	可歎
捨得	不惜	在所不惜	緊追不捨
愛惜	珍惜	體惜	愛	惜	敝帚自珍	珍愛	寸土不讓	惜力
吝惜	吝	不舍	捨不得	難割難捨	難舍難離
憐憫	可憐	同情	憫	憐	惜	哀憐	愛憐	憐恤	體恤	哀矜	憐惜	憐貧惜老	不忍	憐香惜玉	悲憫	同病相憐
忍心	忍	於心何忍
體諒	諒解	諒	原宥
推己及人	將心比心	設身處地
原諒	見諒	擔待	包涵	海涵	涵容	包容	寬容	優容	諒解	容	原	略跡原情
寬恕	寬饒	饒恕	恕	饒	饒命	超生	開恩	留情	容情	寬容	姑息	高抬貴手	手下留情	寬以待人
關懷	關心	關切	關注	眷顧	體貼	知疼著熱	體貼入微	關懷備至	關愛
管閒事	多管閒事
擔心	操心	揪心	顧慮	想不開	放心不下	揪人心肺	顧慮重重	操神	憂念
放心	想得開	如釋重負	釋懷	寬解
注意	留意	經意	在意	小心	留心	在心	經心	上心	留神	理會	矚目	注目	專注	檢點	顧	放在心上	只顧	眭	令人矚目
權衡	衡量	權
計較	斤斤計較	錙銖必較	論斤計兩
重視	珍視	珍惜	尊重	看重	倚重	器重	注重	推崇	賞識	青睞	垂青	講究	重	器	厚	看得起	瞧得起	另眼看待	另眼相看	刮目相看	刮目相待	敝帚自珍	敝帚千金	側重	強調	偏重	垂愛	仰觀	講求
保重	珍重
並重	並列	一視同仁	等量齊觀	相提並論	一概而論	並排	並稱
漠視	無視	冷淡	無所謂	不在乎	滿不在乎	安之若素	一笑置之	付之一笑	掉以輕心	等閒視之	漠然置之	漠不關心
鄙視	蔑視	藐視	輕視	小視	小看	看輕	鄙薄	鄙夷	鄙棄	唾棄	輕蔑	侮蔑	不齒	菲薄	藐	薄	輕	看不起	瞧不起	不屑一顧	嗤之以鼻	文人相輕	小覷	輕敵	貶抑
置之不理	恝置	置之不顧	悍然不顧	撒手不管	置之度外	置若罔聞	置身事外	視若無睹	熟視無睹	恬不為怪	視而不見	充耳不聞	聽而不聞	漠不關心	閉目塞聽	不聞不問	秋風過耳	無動於衷	坐視不管
不置可否	聽其自然	任其自流	無可無不可
閒置	棄置	擱置	廢置	壓	按	擱	撂	束之高閣	置諸高閣	不了了之
丟手	甩手	脫身	撇開
觀望	旁觀	坐視	坐視不救	袖手旁觀	冷眼旁觀	作壁上觀	隔岸觀火	坐觀成敗	坐山觀虎鬥
顧及	照顧	顧全	顧惜	兼顧	顧得上	觀照
顧不上	顧不得
理睬	理會	答理	理	睬	問津
後悔	懊悔	追悔	懺悔	悔恨	悔	自怨自艾	吃後悔藥	悔不當初	抱恨終身	痛悔	背悔
悔改	改悔	悔過	悔罪	悔悟	翻然悔悟	悔過自新	今是昨非
後悔莫及	悔之晚矣	噬臍莫及	一失足成千古恨	追悔莫及	後悔不迭
翻悔	反悔	反顧	悔棋
反省	內省	自省	省察	自問	捫心自問	反躬自問	撫躬自問	內視反聽	閉門思過	反思	反躬自省	捫心自省
無悔	無悔無怨	無怨無悔
願意	情願	甘願	甘心	甘於	樂意	樂於	肯	願	甘心情願	心甘情願	何樂不為	甘當	肯切	何樂而不為
自願	志願	自覺自願	樂得	兩相情願	自覺	願者上鉤
不甘	不甘心	不願	死不瞑目	不甘落後
無意	無心	懶得	一相情願	無意間
敢	敢於	膽敢	竟敢
能夠	能	會	克	力所能及	可知	亦可
善於	長於	擅長	擅	善	工	嫻	健	拿手	善用	能征慣戰
不能	不許	使不得	辦不到	決不能	力所不及	得不到	未能	無從
決不會	不會
可以	得以	足以	得	堪	好	可	足	有何不可	何嘗不可	方可
不可	不得	不行	不興	不足
能否	可不可以	可否	是否
應該	應當	該當	理當	理應	理合	該	應	當	合宜	相應	本當	本該	理所應當	應有	活該	有道是
必須	務須	務必	須要	須	務	要	得	必	必得	非得	總得	不能不	不可不	亟須
無須	毋庸	不必	不用	無庸	不要	不須	無需
何須	何必	何苦
值得	犯得著	犯得上
不值	不足	不屑	不犯	犯不著	犯不上
革命	變革	打天下	打江山
起義	首義
暴動	起事	舉事	發難	造反	反	官逼民反	犯上作亂	揭竿而起	鬧革命	奪權
鋤奸	除暴安良	為民除害
推翻	打倒	推倒	打翻	擊倒	趕下臺
解放	翻身
鬥爭	爭鬥	戰鬥	決鬥	抗暴	角逐	爭雄	爭奪	逐鹿	鬥	龍爭虎鬥	鹿死誰手	搏擊	抗爭	武鬥	戰天鬥地	征戰	爭霸	勇鬥
鬥法	鉤心鬥角	明爭暗鬥	鬥心眼	勾心鬥角
內亂	內訌	兄弟鬩牆	煮豆燃萁	同室操戈	禍起蕭牆	窩裡鬥
百花爭豔	爭奇鬥豔
抗議	反抗	對抗
上臺	登臺	組閣	粉墨登場	登場	袍笏登場	當家做主	初掌帥印
即位	登基	黃袍加身	加冕
繼位	承襲	禪讓
稱帝	稱孤道寡	南面	稱王
當家做主	當家	當家作主
統治	秉國	執政	當政	當道	當權	在位	拿權	掌權	掌印	用事	當家	主政
稱霸	獨霸	稱王稱霸
稱雄	割據	封建割據
下臺	下野	倒臺	倒閣	在野
退位	讓位	遜位
改革	改造	改制	革新	除舊佈新	革故鼎新	興利除弊	激濁揚清	滌瑕蕩穢
變法	維新	改良	變法維新
救國	救亡	赴難	救亡圖存	存亡	斷絕	毀家紓難	救國救民
閉關自守	閉關鎖國	閉關
鎮壓	彈壓	高壓	壓服	壓	超高壓	鎮住
鎮反	肅反	剿除	清剿
討伐	征伐	征討	征	興師問罪	弔民伐罪
平叛	平定	平息	敉平	掃平	掃蕩	圍剿	綏靖	靖	剿	平
篡奪	攘奪	奪取	篡
篡位	問鼎	竊國
顛覆	傾覆
復辟	變天	翻天	倒算	翻天覆地	顛覆
叛變	反叛	叛離	叛	叛亂	叛逆	背叛	反水	倒戈	嘩變	反	策反	謀反	牾
叛賣	出賣	賣	吃裡爬外
通敵	私通	裡通外國	叛國	賣國
投敵	賣身投靠	認賊作父	賣國求榮
招兵	徵兵	募兵	招兵買馬	征丁
抽丁	抽壯丁
裝備	配備	武裝	武備	裝設
備戰	秣馬厲兵	厲兵秣馬	披堅執銳	枕戈待旦	嚴陣以待	摩拳擦掌	磨刀霍霍	磨拳擦掌
誓師	動員
檢閱	閱兵
作戰	打仗	戰鬥	交戰	交火	交鋒	交兵	殺	戰	征	征戰	上陣
接火	接觸	交火	短兵相接	兵戎相見	兵戈相見	赤膊上陣
開戰	開仗	開火	動武	用武	動干戈	宣戰
挑戰	求戰
應戰	應敵	迎戰	迎頭痛擊	後發制人	出戰
奮戰	血戰	浴血奮戰	孤軍奮戰	孤軍作戰
激戰	酣戰	苦戰	鏖戰	鏖兵	打硬仗	惡戰
決戰	決一死戰	一決雌雄	背水一戰	背城借一
會戰	大會戰
轉戰	南征北戰	縱橫馳騁
起兵	動兵	用兵	出兵	出師	出動	興師	進兵	進軍	出征
同室操戈	火拼	內亂	內訌
混戰	群雄逐鹿	干戈四起	干戈擾攘
遊擊	打遊擊
好戰	窮兵黷武
登岸	上岸
急行軍	強行軍
督戰	督軍
進攻	攻擊	出擊	進擊	攻打	強攻	攻	擊	伐	撲	搶攻
圍攻	圍擊
夾攻	夾擊	合擊	分進合擊	內外夾攻
衝擊	衝鋒	衝鋒陷陣	廝殺	衝刺	拼殺
追擊	窮追猛打	乘勝追擊
抵抗	抵禦	抗禦	抵擋	反抗	對抗	招架	拒	抵	抗	敵	禦	迎擊	抗擊	抗拒	頑抗	負隅頑抗	阻抗
招架不住	不可抗力
回擊	還擊	反擊	反攻	反撲	殺回馬槍	反戈一擊
保衛	捍衛	護衛	衛護	侍衛	捍	保	衛
防守	防禦	捍禦	防衛	守	把守	看守	扼守	鎮守	守衛	守護	監守	戍守	戍
佈防	設防
調防	換防
戍邊	邊防
警衛	警備	戒備	衛戍
駐紮	屯紮	駐屯	駐守	駐防	進駐	駐	屯	留駐	屯兵
紮營	宿營	安營紮寨
站崗	放哨	執勤
巡邏	巡查	巡視	巡	哨	巡	巡行	巡迴	徇
射擊	發射	開	發	放	打	打靶
開槍	打槍	槍擊	鳴槍
開炮	放炮	打炮	炮擊	轟擊	炮轟
還擊	回擊
空襲	轟炸	投彈	狂轟濫炸
爆破	炸
刺殺	拼刺刀	肉搏	拼刺
掃雷	排雷	探雷
埋伏	打埋伏	設伏	伏擊
襲擊	侵襲	襲取	掩殺
閃擊	突擊	欲擒故縱
邀擊	攔擊	狙擊	阻擊	截擊
抄襲	兜抄	包抄	迂回	抄
偷營	偷襲	突襲	掩襲	乘其不備
引敵他顧	調虎離山
接應	策應	裡應外合	內應
掩護	打掩護	斷後
牽制	牽	犄角
偵察	偵探	斥	刑偵	偵
包圍	圍困	合圍	圍城	困	圍城打援	圍魏救趙	圍住
突圍	殺出重圍	衝破	打破
侵略	侵犯	進犯	竄犯	侵入	侵越	侵擾	入侵	入寇	犯	寇	侵	進襲
併吞	吞併	侵吞	兼併	侵佔	吞滅	吞噬	蠶食	鯨吞	蠶食鯨吞
騷擾	擾亂	擾	襲擾	喧擾	肆擾	竄擾
攻佔	搶佔	攻克	奪取	襲取	攻破	攻陷	打下	下	破	克	拿下	佔領	攻城掠地	攻城掠地	一鍋端	攻取	把下	奪回
佔據	占	盤踞	龍盤虎踞
收復	克復	光復	取回
擊敗	打敗	戰敗	挫敗	擊破	擊潰	粉碎	重創	敗	破	克敵制勝	各個擊破	制伏
擊退	退	卻
殲滅	剿滅	殲擊	消滅	解決	吃	殲	橫掃千軍	攻殲	全殲	殲敵
圍殲	聚殲	圍剿
摧毀	擊毀	夷
撤兵	收兵	退兵	退卻	撤退	撤防	撤	班師	回師	鳴金收兵	撤走	後撤	撤軍	撤出
俘虜	生擒	生俘	活捉	擒拿	俘獲	俘	虜	執	擒	獲	捉	擒敵	扭獲
繳獲	收穫	截獲	繳	繳械	繳槍	收繳	虜獲
投降	歸降	降服	降順	降	投誠	反正	繳械	解繳
請降	乞降
佯降	詐降
割地	割讓
歸順	歸附	歸心	俯首稱臣
招安	招撫	招降
大敗	潰
治理	經緯	經綸	禦	治	聽	治治	緯	治監
治世	治國	治國安民	安邦定國	勵精圖治	經綸天下	治國安邦	齊家治國平天下	施政
辦理	辦	做	作	幹	操辦
經辦	承辦	經手	過手
包辦	一手包辦	包辦代替
代辦	代理	署理	攝	代勞	代庖	越俎代庖
籌辦	籌畫	籌
處理	料理	操持	處置	處事	安排	措置	處分	從事	裁處
清理	踢蹬	理清	分理
密封	封
管理	經營	掌管	治理	管事	掌	管	理	問	管管	治治	管治
保管	管理	管制	管住	田間管理	治本	軍事管制
綜合治理	綜治
經營	經紀	經理	經	營
國營	國立	公營	公立	公辦	官辦	國辦
私營	私立	民辦
苦心經營	慘澹經營
營業	運營
主營	專營
自主經營	自營
安置	安頓	安排	鋪排	交待
部署	佈局	佈置	配置	配備	布	安排
調動	調	調整
調劑	調節	調試
調撥	劃撥	撥	劃	劃轉	核撥
調遣	調派	調配	選調	調兵遣將
整頓	整飭	整治	整肅	整	飭	整改
整編	改編	收編
派遣	指派	選派	特派	打發	差使	差遣	派	遣	使	差	著	叫	外派	派出
分派	分發	分配	分
支使	支派	使喚	支
指名	點名	指定
建立	成立	樹立	確立	建	立	起	樹	植	起家	白手起家	另起爐灶
立國	開國	建國
建都	奠都	定都
立憲	立法
定居	立業	成家立業	建業	建功立業	置業
架起	搭設
合辦	協辦
設立	設置	開設	開辦	設	開	辦	舉辦	興辦	立	辦起
開闢	辟	開拓	打開
創立	開創	創始	創建	創辦	創造	締造	創設	創	始建	創導	開立
初創	草創
首創	創始	始創
獨創	自我作古	獨闢蹊徑	標新立異	獨樹一幟
創出	創下
命名	定名	起名兒	取名	為名
撤銷	取消	註銷	吊銷	勾銷	繳銷	銷	撤回	收回	撤除	裁撤	撤	撤銷
廢止	廢除	廢黜
免除	罷免	豁免	免去	解除	罷	免	蠲	免予	免掉
解散	遣散
一風吹	一筆勾銷	一筆抹殺
收	接收	收執	收取	收受	收納	接受	接納	接	吸納	吸收	收到	收下	收起	接下	接到	接過
發	頒發	發出	下	行文	下發
發放	發給	關
散發	分發
頒證	發證
請假	告假	續假
主持	主管	掌管	主辦	拿事	司	秉	牽頭
指揮	揮	麾
統率	統領	領隊	帶隊	帶領	率領	提挈	率	引領
執掌	掌握	掌	握	拿	柄
管轄	統轄	統攝	統禦	總統	總理	節制	統制	轄	部	統	管
控制	統制	宰製	主宰	支配	操縱	擺佈	掌握	左右	牽線	駕禦	控	控管
把持	壟斷	佔據	獨佔	收攬	總攬	獨攬	攬	專	霸	據	把	占
召集	招集	集合
宣佈	發佈	公佈	頒佈	發表	宣告	通告	昭示	頒發	揭曉	揭示	披露	頒	公佈於眾
放榜	出榜	張榜	揭榜
下令	命令	指令	通令	傳令	授命	命	令	飭	發號施令	三令五申	發令	吩咐	一聲令下	限令
責令	責成
勒令	強令	喝令
令行禁止	言出法隨
宣傳	宣揚	闡揚	揄揚	揚	鼓吹	造輿論	做廣告	大吹大擂	大喊大叫
發動	鼓動	掀動	動員	總動員	興師動眾	勞師動眾	掀騰
提倡	倡議	首倡	宣導	發起	倡
號召	召喚	呼喚	喚起	召	振臂一呼	感召
喚回	召回
回應	應	一呼百應
呼叫	呼喚
建議	提議	納諫	建言獻計
討論	議論	議事	座談	審議	商議	探討	研討
決定	定規	裁奪	裁決	裁斷	裁定	核定	議定	議決	表決	定奪	公斷	公決	仲裁	決策
定局	拍板	定	決斷	處決	定案	斷	商定
規定	確定
肯定	確認	認可	認定
否定	否決	推翻
制訂	制定	創制
擬訂	擬定	草擬	擬	擬就
登記	註冊	報	掛號	報了名
簽到	報到	記名	登錄
報失	掛失
申請	報名	提請
報考	投考
報告	彙報	上告	上報	呈報	層報	申報	稟報	反映	舉報	回饋
交差	交卷	交代
虛報	浮報	偽報
回報	回話	回稟	覆命
上書	奏
簽字	簽名	具名	署名	簽署	簽	署	簽定	簽約
畫押	簽押	押尾
蓋章	列印	加蓋
批閱	圈閱
批示	批復	批
簽注	簽證	簽
批准	照準	准予	准許	許可	認可	特許	准	獲准	特批	開綠燈	恩准
禁止	取締	查禁	禁	禁絕	不准	明令禁止	嚴令禁止	來不得
禁而不止	屢禁不止	屢禁不絕
解禁	弛禁
調查	考察	查明	踏看	踏勘	踏看	查	查證	檢察	調研
偵查	偵探	偵緝	查訪	察訪	內查外調	明查暗訪	微服私訪	明察暗訪	暗訪	探查	探明
察明	查清
審查	審察	審核	覆核	查對	核對	審	對	按	甄別	甄	核	查處	審結	稽核	核試	稽審	核查	查核	審幹
審定	核准	把關	審驗	核實	檢定
過目	寓目
自審	自查	自糾自查
初查	收審
檢查	稽查	稽考	考查	查看	查	稽	視察	查究	查驗	查考	檢驗	檢視	驗	點驗	驗證	印證	查實	檢	查檢	查查	稽察	檢察
盤查	盤問	查問	查詢	盤根究底	嚴查
聯檢	聯查
監督	督察	監察	督	督查	監察	監控	監理
監視	監	蹲點
監考	監場
督促	釘
查點	清點	檢點	過數	點	盤	清	盤帳	清帳
點名	點卯	唱名
評議	評判	評比	評定	鑒定	裁判	評	判	論	考評	貶褒
評論	評說	評價	講評	品評	臧否	褒貶	品	評	評頭品足	評頭論足	品頭論足	評介
考核	考績	考勤
獎勵	嘉獎	褒獎	獎	賞	獎賞	記功	論功行賞	評功論賞
發獎	授獎	頒獎
金質獎	頭彩	重彩
獎懲	獎罰	賞罰	信賞必罰
表揚	褒揚	表彰	褒	彰	旌
處罰	處分	責罰	懲罰	懲辦	論處	罰	懲	判罰	重罰
開除	革除	開	除名
檢討	檢查	反省	自我批評
選舉	推選	推舉	公推	選	推	舉	選出
選拔	甄拔	挑選	遴選
提拔	提升	擢升	栽培	提挈	擢用	提幹	晉職
聘請	聘任	聘用	延聘	延請	延	聘	請	招錄	特聘
敦聘	禮聘
招聘	徵聘	聘選	招賢納士	選聘	招賢
徵募	招募	徵集	徵召	征	招兵買馬	招生	招收	招用
任命	任	授	除	選
委任	委派	委
封爵	封	拜	加官進爵	授銜	分封	授職
冊立	冊封
任用	起用	擢用	引用	敘用	重用	錄用	選用	收錄	錄取	用	選定	量才錄用	圈定
蔭襲	蔭	封妻蔭子
撤職	革職	免職	罷職	去職	解職	停職	丟官	任免	撤掉
罷官	罷黜	黜免	罷免	斥退	靠邊兒站	清退
貶謫	貶斥	貶黜	謫
雇用	雇傭	雇請	雇工	雇	傭	用活
解雇	解聘	辭退	辭	散	炒魷魚	辭掉
下任	卸任
就職	到職	到任	上任	走馬上任	下車	下車伊始	就任	赴任	走馬赴任	新任
接替	接手	接任	繼任	接班	接	接辦
交卸	移交	交代	交班	交接	交割
辦公	辦公室
辦事	做事
出差	出勤	公出
值班	當班	值勤	值星	值日	輪值
守夜	值夜	夜班
巡夜	查夜
出巡	巡幸
清道	喝道	開道	鳴鑼開道
建築	建造	修建	修築	興修	構築	建	築	修	蓋	打	盤	壘	砌	大興土木	構	組構
動土	動工	施工	破土	破土動工
營造	營建
打夯	夯
改建	改造
翻修	翻蓋	翻
基本建設	基建
架設	架	搭	架構
鋪設	敷設	鋪	街壘	鋪就	鋪砌
養護	護養	養	護
放置	碼放
安裝	裝置	設置	安設	安	裝	安上
裝配	配
組建	組裝
粉刷	抹灰	粉	堊	刷	塗刷
油漆	漆	油	髹	噴漆
裝飾	裝點	裝璜	裝修	點綴	飾	裝潢	裝裱
製造	製作	造作	打造	制	造	做	打	炮製	築造
釀造	釀	釀制
仿造	仿製	克隆
再生	還魂	再造
造假	摻假	摻雜使假
修理	整修	修整	整治	收拾	拾掇	修補	修繕	修葺	修復	修	整	繕	葺	彌合
切削	銑	車
切割	割
焊接	焊
電焊	電弧焊接
鉚接	鉚
冶煉	冶金	熔煉	煉	煉製
鍛造	打鐵	鍛	鍛打	鍛壓
鑄造	澆築	熔鑄	鑄工	翻砂	鑄	電鑄	鑄錠	澆鑄	凝鑄	燒造
軋鋼	軋
衝壓	沖
拉延	拉制
鍍	鋈
熔化	熔	銷	鑠	回爐	熔融	熔斷	煉化
淬火	蘸火	淬
錮露	錮	補
提純	提煉	提制	煉	純化
裂化	裂解
鑲金	錯金
漂白	漂
染色	染
印染	印花
編織	編制	編	打	織	結
繅絲	抽絲
排字	排版
付排	發排
印刷	印
裝訂	訂
出版	問世
發行	刊行
再版	重版
勘察	勘查	查勘	踏勘	勘測	勘驗	考量
勘探	鑽探	探礦
測量	測
開礦	採礦	開採	採掘	采	采采
疏浚	疏通	疏導	宣洩	修浚	疏	浚	釃	瀹	疏開
治水	治理	治	治水改土
防洪	防汛
灌溉	澆灌	澆	沃	灌	灌輸	澆水	澆地
開山	劈山
墾荒	墾殖	開荒	拓荒	開墾
屯墾	屯田
開拓	開闢	開發
種地	種田	稼穡
耕作	耕耘	耕種	耕地	佃
平地	整地	平整	平	耙	耮
破土	墾	坌
耕	犁
耦耕	秋耕	勻播耬
深耕細作	精耕細作
刀耕火種	火種刀耕
間作	間種
套作	套種
連作	重茬
輪作	輪種	倒茬
春化	催青
播種	下種
點播	點種	點	種籽	撒種
耬播	耩
種植	栽種	栽植	植苗	種	植	栽	稼	蒔	種養
栽培	培植	秧
移栽	定植	移植
扡插	插條
培土	耔	翻地
嫁接	枝接	芽接	接穗
整枝	打杈
施肥	糞
條施	溝施
鋤草	除草	芟除	耕田	撓秧	耥	荑	耨	芟
收割	收
打場	脫粒
打獵	狩獵	射獵	出獵	行獵	田獵	獵	田	畋	佃	圍獵	捕獵	獵捕
捕魚	打魚	漁	漁獵	漁撈
釣魚	垂釣	釣
撒網	網
畜牧	牧畜	飼養	養活	養
放牧	牧	放
飼養	畜養	馴養	餵養	調理	哺育	育雛	喂	飼	哺養	豢	豢養
肥育	育肥	催肥
養殖	繁育	培養	放養	養育
配種	配
閹割	去勢	閹	劁	騸
屠宰	宰殺	宰	屠	殺	宰割
出產	生產	產	出	盛產	推出	搞出
貿易	交易	貿	市
通商	流通	商品流通
輸出	出口
輸入	進口	入口
投資	入股	注資	斥資
集資	合股
融資	籌融資
招股	募股
招攬	招徠	兜攬	兜	攬	拉	做廣告	攬客
標價	明碼
講價	議價	討價還價	易貨
要價	討價	開價
抬價	哄抬物價	加價
壓價	殺價	砍價
成交	拍板
買	購	置	販	打	請	辦	進	市	贖	躉	賈	購買	購置	置備	置辦	採購	採辦	包圓兒	購入	購得	買入	選購	購進	買進	進貨
收購	收買	買斷	收訂	購回
訂購	定購	訂貨	定貨	預購	預訂	訂	訂座
郵購	函購
抓藥	打藥
賣	售	貨	沽	賈	鬻	出賣	販賣	出售	發售	售賣	躉售
倒賣	倒騰	購銷	倒手
銷售	銷行	行銷	銷	售貨
兜銷	兜售	推銷
經售	經銷
專賣	榷
拋售	拋
批發	發行	批零	批銷	聯銷
零售	零賣
寄賣	寄售
拍賣	甩賣	處理
出倒	招盤	出盤	盤店	倒	盤
出讓	轉讓	讓
變賣	變	換
脫手	出脫	出手
糶	出糶
炒買炒賣	炒賣	待價而沽
賣掉	賣出	售出
走俏	緊俏
出租	租	租借	租賃	招租	貰	租售
轉租	包租	出頂	頂
租用	租借	租賃	賃	僦	包	頂	租下	承租
營利	賺	扭虧為盈	扭虧增盈	賺錢	扭虧解困	扭虧	創匯	創利
漁利	牟利	居奇牟利	謀利
分紅	分配
翻本	撈本
兌換	換錢	換	兌
兌現	兌付	兌
放債	放款	貸款	借款	拆借	貸
借債	舉債	借貸	告貸	貸	借款	籌借	籌資	舉借
挪借	挪用	墊補	通融	東挪西借
摘借	摘
借支	透支	入不敷出
降息	減利
欠債	欠帳	負債	背債	拉虧空	拉饑荒	負債累累	欠資
欠	該	拖欠
賒欠	賒	掛帳	貰	欠帳	賒帳
討債	索債	要帳	討賬	討還	追回	追索
還債	折帳	償還	償付	還款	還貸
典當	典	當	典押	押當
抵押	押	抵	質	質押
抵帳	抵債
賠償	賠	包賠	賠付	賡
賠款	賠帳
理賠	索賠
贖回	贖
徵收	征	斂	課	清收	征繳	執收
收費	收款	收貸
交納	繳納	上繳	繳	交	納	完	上交	繳付	呈交
交款	繳費	交費
繳稅	交稅	納稅	上稅	完稅	收稅
支付	支出	付出	開發	開支	開銷	支	出	開
付帳	會帳	付	會	計付	給付	交帳	付款
墊付	墊	墊款
付清	付訖
兩訖	收訖
催討	追繳	追交
劃價	計費
偷稅	偷逃稅	偷漏稅	騙稅	逃稅	避稅	偷稅	漏稅
撥款	撥付
記帳	入帳
盤帳	查帳
銷帳	核銷
報帳	報銷	實報實銷
盤點	盤存	盤貨	盤庫
積累	累積	積聚	聚積	積攢	累	積	攢	積澱
積儲	積蓄	蓄積
積久	日積月累	日就月將	積銖累寸	銖積寸累	積少成多	集腋成裘	聚沙成塔	群輕折軸	積弱積貧	積羽沉舟	始於足下	千里之行始於足下	涓滴成溪
花費	花	費	花消	消費
耗費	消耗	耗	吃	淘	損耗	磨耗
白費	枉費
浪費	曠費	糜費	抖摟	荒廢	糟踏
揮霍	糟蹋	暴殄天物	悖入悖出	奢侈浪費
節省	節約	撙節	撙	節	省	省掉	省去
擠出	抽出	騰出
足夠	十足	足	夠	敷	夠用	足足
相抵	抵消	平衡	抵
剩餘	下剩	餘下	剩下	剩餘	多餘	節餘	結餘	盈餘
結存	留存	下存	現存	存
虧欠	虧空	虧累	虧
虧損	虧耗
虧本	虧蝕	賠本
缺少	短少	短缺	缺欠	短欠	缺乏	缺	乏	短	少	虧	欠	差	短斤缺兩	不夠	緊缺	缺失	匱缺
不足	欠缺	闕如	貧乏	貧	絀	供不應求	粥少僧多	僧多粥少	相差
遺漏	脫漏	落	脫	漏	挂一漏萬	疏漏	漏掉
合計	共計	總計	綜計	一共	攏共	統共	總共	合共	一起	共總	歸總	一總	共	凡	合	一股腦兒	累計
駕駛	駕	開	駕馭
駕車	驅車	開車	出車
駕禦	趕	驅	策	禦
搭客	拉腳	捎腳	拉客
搭乘	乘	坐	搭	代步
行駛	駛	行駛
疾駛	奔駛
航行	航
航空	宇航	飛行	飛
上水	上行	上溯
下水	下行
巡航	巡弋	遊弋
划船	搖船	行船	劃槳	泛舟	競渡	翻漿
旅行	行旅	遠足
出行	出外	外出	遠門
遠行	出遠門	長征	遠涉重洋	遠征	飄洋過海
跋涉	跋山涉水	翻山越嶺	涉水	長途跋涉
舟車	車馬	鞍馬
同路	同行
出境	離境	出國	出洋	遠渡重洋	過境
趕路	趲行	趲	兼程
抄道	抄近路	抄近兒	抄小路
繞道	繞遠兒	繞圈子
帶路	引路	領路	領道	嚮導	先導	前導	引導	指引	帶領	帶	領	引	導	指路
引航	引水	領港	領江
領航	導航
搬運	搬	盤
運輸	輸	運	運送	運載
河運	漕運
駁運	駁
流放	放
押運	押送	押車
裝載	裝	載
經過	經由	路過	行經	途經	經	過	由	通	歷經
越過	穿過	通過	穿	過	穿越
渡河	擺渡	渡	航渡
拐彎	轉彎	拐彎抹角
急彎	急轉彎
離開	撤離	背離	開走	去	走	撤出	走人	離去
滾蛋	滾開	滾	走開
背井離鄉	離鄉背井	離家	遠離	離鄉
返回	歸來	回來	回去	返	歸	回	趕回	回到
返鄉	還鄉	回鄉	葉落歸根	落葉歸根
榮歸	衣錦還鄉	榮歸故里
回家	還家	打道回府	返家	金鳳還巢	倦鳥投林
折回	轉回	退回	撤回	折返	重返
複歸	複返
到達	抵達	達	抵	至	到
停靠	停	靠
停泊	下碇	拋錨	泊	灣
教育	教導	教化	感化	教誨	訓誨	訓迪	啟蒙	誨	傅	春風化雨	耳提面命	施教	化雨春風	有教無類	育
諄諄教導	循循善誘	誨人不倦	諄諄教誨
安居而樂教	安居樂教
傳授	傳	授	相傳	口傳心授	衣缽相傳	灌輸	授受
示範	示例	以身作則	言傳身教	現身說法	演示	為人師表	身教勝於言教
開導	誘導	啟發	啟示	啟迪	誘	誘發	迪
發蒙	啟蒙
指點	指	點	指導	點撥	點化
喚醒	喚起	提醒	提拔	發聾振聵	提示	抛磚引玉
引導	指引	引	導	帶	因勢利導	指點迷津
化裝	扮裝	裝扮	扮	假扮	上裝	扮成
卸妝	卸裝	下裝
修養	修身	養氣	修身養性
攝影	留影	拍攝	拍照	照相	照	攝	拍	攝像	攝錄	錄影
調焦	測距
曝光	暴光
沖洗	洗印	顯影	洗	沖	印
錄音	灌音
放映	上映	播出	播映	公映
廣播	播送	播音	放送	播發	播放	播	播講	播報
管教	教養	調教	管	管束	轄制
教訓	訓	訓誡	訓導	訓話
警告	警戒	告誡	以儆效尤	提個醒	警示
講課	授課	講授	講解	教授	教書	教學	講學	執教	上課	上書	主講	教	教課	任課	授業	傳經授道
講習	傳習	教學
訓練	訓	教練
練習	操練	操演	演習	練兵	習	練	勤學苦練
練嗓子	吊嗓子
演武	練功	練武
鍛煉	錘煉	磨練	磨礪	砥礪	淬礪	闖練	闖	千錘百煉	久經考驗	磨煉	鍛錘	闖蕩	洗煉
練出	練就
強身健魄	強身健體
培養	培植	扶植	培訓	陶鑄	栽培	造就	培	樹	養	造	培育	塑造	鑄就
育人	教書育人
試驗	實驗	嘗試	試行	試
考試	考	試	試驗	測驗	考查
大考	期考
應試	應考	下場	趕考
春試	會試
發射	發出	放
學習	念書	讀書	上學	就學	求學	修業	攻讀	深造	讀	念	學	習	上	攻	修	學學
複習	溫習	溫課	複課	習	溫書
自學	自習	自修	進修
實習	見習
半工半讀	勤工儉學	勤工助學
取長補短	用長避短
囫圇吞棗	生吞活剝	不求甚解
重讀	複讀
從師	投師	拜師	受業	執業
模仿	效仿	仿效	模擬	仿照	取法	師法	效法	憲章	祖述	踵武	學舌	因襲	依傍	效尤	仿	法	摹	學	套	效	擬	東施效顰	邯鄲學步	鸚鵡學舌	照貓畫虎	照葫蘆畫瓢	依樣畫葫蘆	如法炮製	人云亦云	亦步亦趨	摹仿
上行下效	上樑不正下樑歪
留學	留洋	鍍金
翹課	曠課	蹺課
閱讀	閱	讀	看	讀書	開卷	翻閱	閱覽	披閱	涉獵
默讀	默誦
讀報	看報
查閱	查看	查	翻	翻開	翻動	翻看
朗讀	宣讀	誦讀	讀	念	誦	朗誦	諷誦
吟詠	詠歎	吟唱	吟誦	哼唧	吟	詠	歎	哼	唪	沉吟
唱酬	酬和	唱和	步韻	和	一唱一和
詩朗誦	吟詩
背誦	記誦	誦	背	背書
揮筆	揮毫	揮灑	執筆	落筆	書寫	命筆	著筆	下筆	寫	書	泐	題	修	開	秉筆直書
大寫	小寫	大處落墨	大書特書	題詩	題寫	奮筆疾書
填	填寫	填充	填空	填入
代筆	捉刀
手書	親筆
抄寫	謄寫	繕寫	謄錄	謄清	抄錄	抄	錄	繕	謄	手抄	傳抄	照抄	抄送
臨摹	摹寫	描摹	影	描	臨	臨帖
默寫	默
塗抹	塗鴉	劃拉	劃線	寫道
劃	扛
提行	抬頭
記錄	筆錄	著錄	記下
記	筆記	速記	簡記
手記	手寫
摘記	摘錄	摘由	摘要	節錄	選錄	摘抄
附筆	附言	附記
解釋	解說	分解	說明	說	講	詮	釋	詮釋	訓詁	釋疑
注釋	詮注	詮釋	注解	注	箋注
引證	引用	摘引	徵引	援引	援用	援	旁徵博引	引述
用典	用事	引經據典
參閱	參見	參看	參照	參考
介紹	說明
標注	標明	標號	標	號	標出
標點	圈點	斷句	圈
評點	批
分析	辨析	剖析	剖解	析	剖	條分縷析	淺析	解析
推敲	琢磨	斟酌	錘煉	字斟句酌	切磋琢磨	推磨
去粗取精	去偽存真
研究	鑽研	鑽	研	研討	切磋
探究	探索	探討	根究	推究	深究	追究	追	探賾索隱
追根	追溯	刨根兒	順藤摸瓜	尋根究底	追根究底	推本溯源	追本窮源	窮原竟委	窮源溯流	刨根問底	追根問底	窮根究底
摳	摳字眼兒	鑽牛角尖	咬文嚼字
考證	考據	查考	考究
分類	分門別類	分揀	歸類
歸納	歸結	概括	總括	綜合	綜	綜上所述	綜述	匯總	集錦
總結	小結	下結論	總
推理	推導	推求	推演	演繹
類推	類比	舉一反三	觸類旁通	以此類推	依此類推
寫作	著作	創作	編寫	編	撰	寫	著	做	作	作文	綴文	行文	撰著	編著	著述	立言	命筆	筆耕	耍筆桿	著書立說	著書	著文	撰寫	練筆	撰文	爬格子	文墨
起草	草	起	擬	草擬	擬稿	擬議	起稿
佈局	搭架子
執筆	動筆
完稿	殺青	汗青
編造	臆造	虛構	虛擬	杜撰
堆砌	雕砌	尋章摘句	舞文弄墨	疊床架屋
譜曲	作曲	譜寫
作詩	賦詩	詠	吟風弄月	嘲風詠月
合著	合寫	合編
編成	作出
翻譯	翻	譯	通譯	重譯
音譯	譯音
編輯	編纂	編撰	編寫	編制	修	編	纂	輯	綴輯	編排	編次
編錄	輯錄	摘錄	剪輯	剪接
補遺	補正	增補	拾遺	拾遺補闕
校對	校	校改	審校	校準
校訂	校勘	校核	校正	校閱
潤色	潤飾	修飾	點染	增輝
修改	改動	改	竄	竄改	雌黃	塗改	修定	修修改改	改改	批改
更正	修正	匡正	匡
指正	雅正	呈正	斧正
刪改	刪節	刪繁就簡
刪除	剔除	芟除	去除	除去	刪	剔	抹	勾	去	刪去	刨除	刪減
改錯	糾錯
修訂	審訂	考訂
訂正	勘誤	正誤
繪畫	描畫	描繪	畫	繪	寫	描	打	寫生	點染	畫畫	作畫
畫像	寫真	傳真
勾	勾勒	勾畫
著色	上色	設色
渲	渲染
製圖	繪圖	繪製	打樣	作圖
雕刻	鐫刻	鏤刻	鏤空	雕琢	琢磨	雕	刻	鐫	摳	勒	鏨	鋟	鏤	鎪	精雕細刻	雕飾	摹刻
雕花	鏤花
醫治	醫	治	看	療	治病	看病	醫療	治療	診療	診治	臨床
診	聽診	診察	診視
診斷	確診
診脈	號脈	切脈	把脈	按脈
行醫	救死扶傷
就醫	就診	看病	診病
求醫	求治
救治	救護	搶救	急救	急診
消毒	殺菌
刮痧	揪痧
修補	修復
消腫	消炎
打針	注射
扎針	針刺
補液	輸液
種痘	種牛痘	種花
開刀	動手術
配藥	配方
下藥	投藥	用藥	施藥
接生	接產
打胎	刮宮	人流	人工流產	墮胎
演出	表演	演	上演	公演	獻藝	獻技	賣藝	演藝
配戲	跑龍套
會演	匯演
預演	試演
武打	短打	打出手
打諢	插科打諢
出臺	出場	上	上場	上臺	登臺	登場	鳴鑼登場	出演
下臺	下場	下
排演	排戲	排練	排	彩排	演練
扮演	飾演	裝扮	串演	串	扮	飾	裝	去	扮作
唱歌	唱	歌	謳歌	歌唱	歌詠	謳
高唱	高歌	歡歌	引吭高歌
悲歌	長歌當哭
哼	哼唧	哼唱
對唱	對歌	對口
幫腔	和
變調	移調	轉調
跳舞	舞蹈	舞	翩翩起舞	翩躚起舞	翩然起舞	婆娑起舞	起舞
歌舞	輕歌曼舞	載歌載舞
演奏	奏樂	作樂	吹打	奏
吹奏	吹	品
彈奏	彈
拍板	擊節	打拍子
發球	開球
攔網	封網
踢球	蹴鞠
打拳	練拳
溜冰	滑冰
游泳	游水	遊	擊水	衝浪
蝶泳	海豚泳
下棋	著棋	對弈	對局	弈	博弈
將	將軍
比賽	競賽	比試	競技	較量	交鋒	角	鬥	比	賽	競
賽馬	跑馬
爭衡	奪標	擺擂臺	打擂臺	見高低	決一雌雄	決一勝負
奧林匹克	奧運會
爭奇鬥豔	爭妍鬥麗
見分曉	見雌雄
勝利	奪魁	勝
蟬聯	衛冕
交際	應酬	酬酢	酬應	周旋	張羅	社交	打交道	交道
交往	來往	往來	往還	走動	走	過從	過往	往復	接觸	一來二去	有來有往	明來暗往	酒食征逐
結交	相交	締交	神交	交接	交遊	會友	結識	交	軋
交好	通好	修好	親善	友善	相好	和睦相處
拉關係	拉交情	套交情	套近乎	拉近乎	搞關係
處世	做人	待人接物	立身處世	為人處事	作人
相處	相與	處
睦鄰	友鄰
憑藉	借助
訪問	拜訪	拜謁	拜會	造訪	走訪	做客	作客	拜望	訪	拜	看	顧	聘	尋親訪友
登門	上門
回訪	回拜
進見	晉見	參見	謁見	晉謁	參謁	參拜	拜見	見	拜
朝見	覲見	朝覲	上朝
探望	看望	省視	探視	探訪	探問	看	望	瞧	探	省	看看	細瞧
省親	探親
走親戚	串親戚
串門子	走門串戶	走村串戶	串門	走家串戶	走街串戶	跑門串門	走村串寨	走街串巷
邀請	約請	敦請	特約	邀	約	請	三顧茅廬	敬請	特邀	有請	誠邀
邀集	約集
約定	說定	預定	預約
約稿	稿約
赴約	踐約	履約	應邀
守信	言而有信	一諾千金	一言為定	說到做到	守信用
算數	算	作數
踐諾	實踐	還願
失信	食言	黃牛	自食其言	食言而肥	背信棄義	言而無信	出爾反爾	輕諾寡信
失約	負約	破約	違約	爽約
翻臉	鬧翻
迎接	迎迓	迎候	出迎	歡迎	迎	接	逆	迓
迎賓	夾道歡迎	喜迎	笑臉相迎
會面	見面	晤面	會見	會	晤	會晤	會客	碰頭	照面	相會
陪伴	陪	伴	陪同	伴同	隨同	伴隨	奉陪
做伴	作陪	為伴	相伴	作伴
接送	迎送
送別	送行	歡送	送客	送
餞行	餞別
告別	告辭	辭別	拜別	辭行	辭
等候	聽候	佇候	守候	等候	候	等	待	俟	虛位以待	伺機	拭目以待	等待
少待	稍候
坐等	坐待
有待	有待於
驅逐	趕走	趕跑	趕	轟	攆	逐	掃地出門	驅遣	驅趕
收留	收容	收養	容留
挽留	款留	留
招呼	打招呼
招待	接待	款待	待	遇	待遇
對待	對	待	待遇	看待	相待
寬待	優待	厚待	恩遇	禮遇
虐待	淩虐	肆虐
對付	應付	纏
過場	走過場	逢場作戲
敷衍	應付	搪塞	應景	搪	虛應故事	虛與委蛇	敷衍了事	敷衍塞責	含糊其詞
祝願	祝	祝頌	祝福
祝賀	慶賀	道賀	道喜	慶	賀	拜	恭喜
慶祝	慶	歡慶
賀年	拜年	恭賀新禧	賀歲	賀春	團拜
祝壽	拜夀	紀壽
鬧新房	暖房
請安	問安	問好	問候	問訊	致意	致敬
寫信	來信	通信	致函	修函	上書	鴻雁傳書	致信
投書	投送	下帖	寄信	發信
覆信	回信	複	函複	回函	復函
匯款	郵匯	信匯	電匯	匯	郵	匯寄
郵寄	付郵	郵	寄	投	郵遞	郵發
投遞	遞送	送
拍電報	發報	電告	電	打電報	發電	致電
打電話	掛電話	通電話	通話
講話	說話	談話	發話	出言	開口	出口	開腔	張嘴	呱嗒	言語	說	談	操	道	語	言	講	敘	稱	雲	曰	提	嘮	擺	說道	講講	談道
吭聲	吭氣	吭	做聲	則聲	啟齒	吱聲
耳語	私語	低語	咬耳朵	咕唧	哼唧	喳喳	囔囔	嘀咕	竊竊私語	交頭接耳	輕言細語	喃語	細語
咕噥	咕唧	咕嚕	嘟囔	嘟嚕	自言自語	自語	夫子自道	念念有詞	唧噥
嘮叨	叨嘮	絮叨	絮語	饒舌	多嘴	磨牙	耍貧嘴	耍嘴皮子	磨嘴皮子	刺刺不休	呶呶不休	嘵嘵不休	喋喋不休	念叨
嚕蘇	贅言	贅述	廢話	費口舌	哩哩羅羅
炒冷飯	舊調重彈	重提
瞎說	亂說	胡說	胡扯	瞎扯	瞎謅	嚼舌	放屁	亂彈琴	胡言亂語	胡說八道	說夢話	鬼話連篇	信口開河	信口雌黃	言不及義	胡言	胡謅	戲說
吞吐	吭哧	支吾	閃爍其辭	含糊其辭	吞吞吐吐	支支吾吾
直言	和盤托出	直言不諱	仗義執言	開門見山	打開天窗說亮話	直抒己見	直說
傾訴	傾吐	傾談	傾倒	訴	吐訴	一吐為快
訴說	陳訴	訴
鼓舌	搖唇鼓舌	花言巧語	嘩眾取寵	巧言如簧	能說會道	調嘴弄舌
插話	插嘴	插口	多嘴
搭腔	搭話	搭理	答茬兒	接茬	搭訕
說笑	耍笑	談笑	笑語	有說有笑	談笑風生	歡談
會話	對話	人機會話
侈談	唱高調	誇誇其談	高談闊論
空談	放空炮	說空話	坐而論道	紙上談兵	空口說白話
話舊	敘舊
話別	敘別	道別
交談	敘談	攀談	搭腔	過話	交口
面談	晤談	面議
泛泛而談	淺說	清談
懇談	交心	談心	促膝談心	娓娓而談	娓娓道來	長談
暢談	傾談	暢敘	暢所欲言	傾心吐膽
漫談	縱談	漫話
斷言	預言
說閒話	閒言閒語	說長道短	說三道四
冷言冷語	吹冷風	潑冷水
慷慨陳辭	侃侃而談
一語道破	一語破的	一針見血
總而言之	總之	一言以蔽之	總的說來	總起來講
歡歌笑語	歡聲笑語
致詞	致辭
談天	聊天兒	閒扯	拉扯	閒談	聊	閒聊	閒話	說閒話	拉	扯	扯淡	閒磕牙	拉家常	話家常	敘家常	擺龍門陣	談天說地	東拉西扯	侃侃	你一言我一語	促膝交談	聊聊	聊天	侃	談古論今
神聊	說東道西	拉三扯四
演講	講演	演說	發言
論述	論說	闡述	闡釋	闡發	論
列舉	羅列	臚列	論列	數說	毛舉細故	歷數	點數
敘述	敘說	講述	敘	平鋪直敘	描述
陳述	陳說	臚陳	陳	述	陳言
詳述	慷慨陳詞	前述	細說	詳談
鋪敘	鋪陳	敷衍	縷述	縷陳
述說	稱述	誦
追述	追敘	記述	憶述
記敘	記事	記載	敘寫
聲稱	宣稱	宣示	揚言	聲言	聲明
描寫	描繪	寫	狀	描摹	刻畫	形容	勾畫	勾勒	勾	摹寫	寫照	抒寫
寫實	寫真
表示	示意	表
吹風	放風
志	道	申	鳴
暗示	丟眼色	使眼色	授意
表達	抒發	發表	抒	達	發揮	表述	致以
抒情	抒懷	抒情暢懷
闡明	闡發	發明	說明	表明	申明	申說	申述	申	表
表白	剖白
表露	吐露	披露	透露	說出	露
發誓	盟誓	立誓	宣誓	起誓	賭咒	誓	矢	誓死
告訴	告知	奉告	報告	告	曉	喻	語	報
稟告	稟	回稟
曉諭	曉示	誥	詔	諭
轉告	轉達	傳達	傳言	傳話	過話
預告	預報	測報
告警	報警
告捷	報捷
通知	知照	關照	知會	照會	通告	通	通報	報信	送信兒	打招呼
透風	通風報信
囑咐	叮囑	丁寧	交代	囑	叮	授	叮嚀	囑事
介紹	引見	牽線	穿針引線
說合	撮合	說	說說
說媒	做媒	保媒	說親	提親
搭橋	牽線搭橋
推薦	引薦	舉薦	薦舉	薦	援引	引進	推舉	搭線	推介
保薦	保舉	保送
自薦	毛遂自薦	自告奮勇
露面	照面兒	露頭	抛頭露面	冒頭
出面	出名	出臺	出頭	出馬	出頭露面
代替	代表	替代	頂替	取代	代	替	取而代之	指代
替班	頂班
問	發問	提問	訊問	問訊	叩問	叩	問話	問問	詢	諏	諮詢	訾
查問	查詢	詢問	諮	諏
盤問	細問	盤詰	問長問短	盤根究底
追問	詰問	追詢
反問	反詰
責問	詰問	質問	問罪	喝問
質問	質疑	質疑問難	質詢
請示	請命	報請
答	回答	回復	對答	答應	應答	答覆	答話	回話	答對	應對	酬對	酬答	酬	對	應	回	報	答問	回應	作答	解惑	答疑
對質	對簿	對證
吹牛	說嘴	誇口	吹	說大話	誇海口	吹牛皮	口出狂言	大言不慚	胡吹	詡
自誇	自詡	伐	自賣自誇	自吹自擂	賣狗皮膏藥
吹噓	鼓吹	標榜	美化	樹碑立傳
誇張	虛誇	浮誇	誇大	誇耀	誇	誇大其詞	言過其實	誇大其辭
說謊	扯謊	撒謊	扯白	佯言	瞎說	說鬼話	說瞎話	胡謅
造謠	造謠惑眾	謠言惑眾	妖言惑眾	蠱惑人心	造謠中傷	蜚短流長	憑空捏造
放空氣	放冷風	放風
隱瞞	隱秘	隱匿	背	瞞	背著	閉口不談	不說
掩蓋	掩飾	遮蓋	遮羞	遮掩	隱諱	諱言	諱	諱莫如深
打掩護	打埋伏
粉飾	矯飾	文飾	文過飾非	塗脂抹粉	粉飾太平	搽脂抹粉
保密	秘	守口如瓶
揭露	揭發	揭破	點破	揭	揭底	揭開	揭秘
揭穿	說穿	拆穿	戳穿	捅	抖摟	揭老底	揭短
責備	責怪	指責	斥責	叱責	指斥	痛斥	訓斥	申斥	指斥	指摘	非難	責難	非議	詬病	彈射	申飭	數說	數落	數叨	搶白	責	斥	怨	謫	非	咎	罵	怪	呲	熊	派不是	痛責	喝斥	橫加指責	微辭	指指點點
自責	自咎	引咎	引咎自責	自我批評
苛責	求全責備
譴責	聲討	申討	譴
批評	開炮	放炮	針砭	針砭時弊
批判	批	揭批
批駁	駁斥	駁倒	反駁	駁
抹殺	勾銷	一筆抹殺	一筆勾銷	一棍子打死	一筆抹煞
攻擊	抨擊	掊擊	鞭撻	大張撻伐	口誅筆伐	挨鬥	訐
承認	確認	認可	肯定	認同	認帳
認錯	認罪	認輸	認命
否認	否定	不認帳	矢口否認	矢口
抵賴	狡賴	賴	矢口抵賴	賴帳	賴債	賴皮	賴帳
過問	干預	干涉
介入	參與	沾手	插手	插足	插身	廁身	廁	與	涉足	踏足	涉企
打聽	探聽	打探	探問	打問	詢問	叩問	探詢	刺探	摸底	瞭解	問詢	垂詢
摸清	探明	摸透
試探	試	探	詐	探口氣	探路	探察
請求	乞求	懇求	央求	央告	求告	呈請	懇請	籲請	呼籲	伸手	求	央	要	告	請	籲
求助	求援	乞援	告急	求救	呼救
求饒	告饒	討饒
哀求	哀告	央求
徵求	徵詢	征	征得
乞憐	搖尾乞憐	乞哀告憐
委託	付託	囑託	信託	寄託	託付	托	寄
拜託	央托	託人情	托人
講情	說情	求情	討情	說項	美言	緩頰
贈送	饋送	奉送	饋贈	捐贈	贈與	饋	贈	餼	齎	貽	送	遺	給	贈給	贈予
轉送	轉贈	借花獻佛
送禮	送人情
回禮	還禮	回贈
賞賜	賞	賜	賚	貺	賜予
贈答	投桃報李	禮尚往來	互通有無
捐獻	捐	輸	白送
獻	奉	呈獻	貢獻	奉獻	孝敬
進貢	朝貢
捐給	獻給
交	提交	交付	交給	付諸	付出	付	授	送交	給出	交到	交由	付給
呈	上
面交	遞交	呈遞	遞	呈送	遞給
轉交	轉送	傳遞	傳送
付費	付錢
取	領取	提取	提	領	領到
借	借用	假	借出
出借	借給	借	放貸	貸出
歸還	發還	奉還	清還	清償	償清	償還	償	還	歸	璧還	完璧歸趙	送還	物歸原主	還給
退還	退回	退	吐出	退賠	賠還	退掉	清退
交換	互換	掉換	串換	對調	換	易
掉包	偷樑換柱	偷天換日
更換	更替
傳遞	傳接	傳送
催促	催	促
抵償	抵	償
感謝	感	謝	謝謝	道謝	稱謝	致謝	申謝	鳴謝	璧謝	感恩戴德
酬謝	酬答	酬勞	酬報	酬	酬賓
答謝	謝恩
報答	報償	報	答	補報	結草銜環	報經
道歉	致歉	賠罪	賠禮	賠不是	賠小心	賠禮道歉
請罪	負荊請罪
謙讓	禮讓	忍讓	推讓	辭讓	讓	讓給
讓座	讓位
讓路	讓道
讓步	退讓	退避三舍	服軟
遷就	將就
協商	相商	籌商	磋商	情商	商談	商議	計議	協議	商討	商榷	商量	商兌	商酌	商計	合計	說道	商	議	謀	共謀	共商	商事	議商	協和
談判	交涉	討價還價	折衝樽俎
會商	會談
接洽	面洽	洽	商洽	洽商	洽談
和平談判	和談
訂約	締約	立約	締結	簽訂	訂立	訂	立	協定	約法三章	立下	商定
答應	應	應允	許	諾	應諾	承諾	然諾	許諾	允諾	應承	承當
允許	容許	同意	允	容	興	許
拒絕	回絕	拒	推卻	推辭	不容	駁回	拒諫飾非	拒人千里	閉門羹	拒人於千里之外	不肯
謝絕	辭謝	謝卻	婉辭	回絕	敬謝不敏	婉言謝絕	婉拒
推託	推	假託	托	藉口	推三阻四	託辭
搪塞	搪
推卸	推委	推脫	推	卸	溜肩膀	推諉	踢皮球	諉
委罪	歸咎	歸罪	罪
鼓勵	勉勵	打氣	砥礪	嘉勉	慰勉	勸勉	勉	劭	勵	鞭策	勵人	懋	釗	勖
激勵	激揚	激發	鼓勁
勸告	相勸	規勸	奉勸	勸導	勸戒	勸誘	勸說	勸	侑	規	箴	告誡	好說歹說	勸誡	諄諄告誡	橫說豎說	敦勸
規諫	進言	諫	諍	諗
遊說	說
勸阻	勸止	勸退
安慰	勸慰	撫慰	安撫	撫	慰	慰藉	溫存
慰勞	慰問	撫慰	勞	犒勞	犒賞	慰唁	問寒問暖	噓寒問暖
幫助	扶助	協助	贊助	援助	臂助	救助	匡助	輔助	襄助	相幫	幫忙	幫襯	支援	增援	聲援	搭手	援手	扶持	扶植	扶	拉扯	扶掖	提攜	提挈	助	幫	輔	援	拉	襄	協	匡扶	受助	幫帶	佑助	八方支援	鼎力相助	有難必幫	相助	幫扶
互助	互濟	相濡以沫	互幫互助
周濟	接濟	救濟	濟	施捨	濟貧	慷慨解囊	解囊相助	助人為樂	仗義疏財	濟困扶危	扶貧	扶貧幫困	殺富濟貧	濟困	幫貧濟困	扶貧濟困	幫困	助困	扶貧助困	解困扶貧
救急	雪中送炭
幫襯	補助	捐助	資助
賑濟	賑
行善	行好	行方便	積德	行善積德	與人為善
成全	周全	作成	圓成	玉成	成人之美
輔佐	佐
助威	助戰	捧場	搖旗呐喊	呐喊助威
支持	幫腔	撐腰	敲邊鼓
打下手	跑腿
拯救	救	拯	搭救	解救	搶救	營救	匡救	挽救	援救	救援	匡	救苦救難	救死扶傷	普渡眾生	從井救人	救危排險	救難	救救	施救	馳援
救命	救生	救人
救火	撲救	滅火	撲火
救活	活命	活
救應	接應
獻計	獻策	出點子	出謀劃策	搖鵝毛扇	出謀獻策	建言獻策
照顧	照拂	照料	照應	照看	照管	看管	看	關照	招呼	觀照
服侍	伺候	侍奉	事	侍	侍候	侍弄	伴伺
護理	看護	守護	照護	護養	醫護
保護	掩護	衛護	護衛	護	保安	保障	維護
保駕	保鏢
護身	防身
收養	認領
領養	抱養	抱
撫養	拉扯	養活	扶養	拉	育	養	養育	鞠
保育	撫育	護養
贍養	奉養	供養	供奉	養老	菽水承歡
遵守	信守	嚴守	死守	恪守	守	遵	遵照	遵從	遵循	迪	恪	聽命
遵命	奉命	從命	遵奉
聽從	順從	依從	服從	依順	順	從	依	聽	服帖	伏帖	順服	言聽計從	從善如流	從諫如流	伏貼	服服帖帖	順乎
違背	違反	違拗	違	迕	拂	失	負	背	背棄	背離	背道而馳	反其道而行之
違犯	觸犯	犯忌	犯
抗拒	抗	抗命	對抗	違抗	抵制
稱讚	誇讚	詠贊	稱譽	讚譽	讚美	讚歎	讚頌	歎賞	稱賞	讚賞	稱道	稱許	稱頌	讚揚	揄揚	頌揚	褒揚	歌頌	謳歌	歌唱	嘉許	贊許	褒獎	誇獎	抬舉	叫好	贊	譽	嘉	稱	頌	褒	誇	許	拍手叫好	禮贊	讚歎不已	嘖嘖稱讚
盛讚	歎為觀止	拍案叫絕	交口稱譽	有口皆碑	口碑載道	歌功頌德	讚不絕口	盛譽	交口稱讚	眾口交贊
過獎	過譽
恥笑	取笑	譏笑	嘲笑	訕笑	嗤笑	見笑	笑	笑話	寒磣	寒傖	貽笑大方
譏諷	嘲諷	諷	諷刺	譏誚	譏嘲	譏	挖苦	揶揄	奚落	反唇相譏	冷嘲熱諷	誚
醜化	搞臭	抹黑
誣衊	污蔑	誣賴	誣陷	詆毀	誹謗	譭謗	中傷	非議	訾議	造謠	讒	詆	謗	含血噴人	血口噴人	造謠中傷	惡語中傷	吡	謠諑	姍
反咬一口	倒打一耙
爭論	爭議	計較	爭辯	爭執	說嘴	爭	爭長論短	爭持	爭斤論兩	爭論不休
辯論	辯	爭辯	聲辯	申辯	置辯	答辯	說理	講理	論理	論戰	論爭	駁	辯駁	反駁	回駁	駁斥	舌戰	辯解	辯護	爭鳴	理論	舌劍唇槍	力排眾議
分辨	分說	辯白	辯解	分辯
狡辯	強辯	詭辯	鼓舌	胡攪	巧辯
議論	討論	講論	座談	談論	談談
公議	公論
妄下雌黃	信口雌黃	強作解人
街談巷議	議論紛紛	說長道短	說短論長
大放厥詞	厥詞
罵	詈
責駡	叱駡	斥駡	唾駡	叫駡	駡街	罵罵咧咧
痛駡	臭駡	破口大駡
咒駡	詛咒
怒斥	叱喝	叱	怒駡
呵責	呵斥	申斥
辱駡	詬罵	漫駡	漫駡	笑駡	謾駡
對罵	罵架
爭吵	吵	口角	吵嘴	爭嘴	鬥嘴	拌嘴	口舌	扯皮	吵架	抬杠	抬	破臉	抓破臉
頂嘴	還嘴	回嘴	強嘴
頂撞	頂
吵鬧	鬧	嚷	哄	起哄	叫囂	大吵大鬧	又哭又鬧	哭鬧	罵娘	有哭有鬧
鬧意見	鬧彆扭
作對	頂牛兒
毆打	打	毆	動武	揮拳	拳打腳踢	毆鬥
打架	對打	爭鬥	搏鬥	格鬥	抓撓	動手	動武	交手	打	鬥	大打出手	鬥毆	打鬥	搏	搏殺	大動干戈	角鬥	揪鬥
打傷	擊傷
調解	排解	調停	調處	調和	勸和	說和	說合	疏通	斡旋	打圓場	和稀泥	息事寧人	排難解紛	圓場
拉架	勸架	勸解	解勸
屈服	懾服	降服	臣服	低頭	屈從	讓步	妥協	投降	伏	服	降	俯首稱臣	拗不過	折衷
降伏	收服	降	服	伏	馴	馴服	折服
說服	以理服人	說動	疏堵
講和	媾和	言和	議和	和解	和好	和	言歸於好	握手言歡	握手言和
諂媚	獻媚	狐媚	阿諛	諂諛	討好	買好	賣好	取悅	吹捧	捧場	奉承	巴結	逢迎	拍	捧	諂	阿	諂	媚	獻殷勤	抬轎子	吹吹拍拍	戴高帽子	投其所好	偷合苟容	曲意逢迎	脅肩諂笑	溜鬚拍馬	諛	阿諛逢迎	阿諛奉承	點頭哈腰	拍馬屁	曲意奉承	巴結	恭維
籠絡	牢籠	收攬	收買	拉攏	收攏	懷柔
攀附	攀緣	夤緣	趨附	趨奉	攀龍附鳳	如蟻附膻	趨炎附勢
迎合	投其所好
包庇	庇護	袒護	護短	庇蔭	蔭庇	黨	打掩護	官官相護	貓鼠同眠
偏袒	偏護	偏向	向著	左袒	左右袒
放任	任憑	聽憑	聽便	聽任	聽	任	縱	放	逞	放任自流	任其自流	聽其自然	聽之任之	自由放任
姑息遷就	牽就
縱容	縱令	放縱	嬌縱	慣
姑息	寬縱	姑息養奸
自暴自棄	破罐破摔
欺騙	矇騙	誆騙	詐騙	哄騙	瞞騙	誘騙	瞞哄	欺詐	哄	誆	欺	騙	蒙	虞	詐	謾	譎	爾虞我詐	招搖撞騙	掩人耳目	爾詐我虞	障人眼目	坑蒙拐騙
耍花招	耍花腔	玩花樣	作假	使壞	耍滑頭	弄虛作假	耍花槍	耍滑	耍手段	耍心眼兒	偷奸取巧	偷奸耍滑	投機取巧	鑽空子
欺瞞	蒙蔽	蒙哄	蒙混	打馬虎眼	欺上瞞下	瞞上欺下	瞞天過海
迷惑	糊弄	惑	故弄玄虛	惑人耳目
偷樑換柱	偷天換日
自欺欺人	掩耳盜鈴	掩目捕雀	瞞心昧己
騙人	坑人
搗鬼	搞鬼	做鬼	弄鬼	做手腳	上下其手	耍花樣
得罪	冒犯	觸犯	沖犯	衝撞	頂撞	唐突	攖	犯	太歲頭上動土
激怒	觸怒
糾纏	軟磨	纏繞	蘑菇	泡蘑菇	磨蹭	磨	嬲	纏	繞	胡攪蠻纏	死皮賴臉	死氣白賴	磨嘴皮
抓辮子	揪辮子
打攪	攪	打擾	攪擾	煩擾	干擾	侵擾	驚擾	驚動	攪亂	搗亂	擾亂	攪和
麻煩	煩勞	勞神	費事	勞駕	勞	煩	贅	找麻煩	添麻煩	困擾
阻攔	阻撓	阻擋	阻止	攔阻	攔擋	攔截	掣肘	梗阻	擋駕	阻礙	窒礙	阻遏	遏止	阻	攔	遮	擋	阻截	阻滯	截住	攔住	擋住	堵住	封阻	力阻	遮攔	截留
堵嘴	免開尊口	阻斷
擋路	阻路	封路
拉後腿	扯後腿	拖後腿
拆臺	挖牆腳	拆牆腳
耍賴	撒賴	撒潑	撒刁	耍無賴	耍賴皮	耍流氓
刁難	放刁	作梗	難為	作難	為難	留難	作對	拿人	拿	窘	過不去	百般刁難	出難題
挑剔	挑眼	挑刺兒	找碴兒	吹毛求疵	挑毛揀刺	挑字眼兒	咬字眼兒	挑毛病	橫挑鼻子豎挑眼
引逗	挑逗	逗引	逗弄	逗	招惹	招	惹	撩
戲弄	捉弄	作弄	調弄	撮弄	嘲弄	耍弄	玩弄	調戲	調侃	戲耍	戲	耍	玩兒	愚弄	愚	惡作劇
開玩笑	調笑	戲謔	諧謔	鬥嘴	開心	謔	打哈哈	尋開心	逗悶子	鬧著玩兒
逗笑兒	逗樂兒	逗趣兒	湊趣兒	打趣	打趣逗樂	逗笑	逗趣
擺佈	擺弄	播弄	撥弄	任人擺佈
慫恿	唆使	嗾使	教唆	挑唆	撮弄	扇動	扇惑	誘惑	攛掇	攛弄	煽風點火	煽	煽動	煽惑	慫	順風吹火
指使	主使	讓	叫
強迫	逼迫	強逼	迫使	強使	驅使	驅策	勒逼	勒	迫	逼	催逼	強求	緊逼	進逼
勉強	強人所難	勉為其難
挾制	強制	要脅	挾持	脅持	劫持	裹脅
恐嚇	恫嚇	威嚇	嚇唬	驚嚇	嚇	唬	詐唬	哄嚇
威脅	威懾	脅迫	威逼	脅	脅從
核威脅	核威懾
引誘	勾引	利誘	誘惑	誘	餌	啖	吊胃口	引蛇出洞	威脅利誘	循循誘人	煽惑	誘使
欺負	欺侮	欺淩	欺壓	欺生	淩虐	侮	氣	暴	淩	以強淩弱	諂上欺下	狐假虎威	狗仗人勢	仗勢欺人	藉
蹂躪	踐踏	作踐	魚肉	殘害	強姦	糟踏	動手動腳	施暴	輪奸
侮辱	污辱	辱	淩辱	折辱	糟蹋	糟踐	侮慢
排擠	排斥	擯斥	傾軋	軋	黨同伐異	擠兌	排外	互斥	擠掉
陷害	讒害	坑害	誣陷	構陷	誣賴	誣害	誣陷	坑	賴	冤枉	冤屈	羅織	深文周納	嫁禍於人	以鄰為壑
暗害	暗算	算計	計算	放暗箭	暗箭傷人	殺人不見血	謀害
下藥	毒	鴆	鴆毒
乘人之危	趁火打劫	投井下石	落井下石	落井投石	打落水狗
危害	為害
勾結	勾搭	串通	勾通	通同	串	唱雙簧	朋比為奸	狼狽為奸	拉拉扯扯	串通一氣	沆瀣一氣	同流合污	一鼻孔出氣	勾連
幫兇	助桀為虐	為虎傅翼	為虎作倀	助紂為虐
挑撥	挑唆	調唆	調弄	播弄	鼓搗	搗鼓	離間	挑	挑撥離間	搬弄是非	間離
破壞	敗壞	損壞	糟蹋
壞事	誤事	幫倒忙	成事不足，敗事有餘
侵害	侵蝕	侵越	侵犯	犯
毒害	流毒	荼毒	蠱惑	麻醉
腐蝕	銷蝕	風剝雨蝕	浸蝕
報仇	復仇	報仇	算帳
公報私仇	官報私仇
報復	複	穿小鞋	以牙還牙	睚眥必報
回報	報	報恩
雪冤	申雪	昭雪
結伴	搭伴	搭夥	搭幫	結對
結夥	為伍	拉幫結派	結黨營私	招降納叛
拜盟	拜把子	結拜
結盟	同盟	聯盟	歃血為盟	拉幫結夥	歃血結盟
斷交	絕交	一刀兩斷
散夥	拆夥	作鳥獸散
生活	過活	過日子	吃飯	起居	飲食起居	衣食住行	安身立命	安家立業	度日	食宿
謀生	營生	求生	為生	糊口	度命	立身
居住	住	居	居留	棲身	安身	容身	卜居	存身	棲居	位居
群居	聚居	混居
小住	暫住	暫居	落腳
寄居	旅居	僑居	寄寓	寓居	作客	客居	流落
定居	安家	落戶	安家落戶
隱居	蟄居	蟄伏	幽居	隱	閉門謝客	歸隱
住宿	歇宿	留宿	宿	借宿	投宿	寄宿	下榻	過夜	夜宿
露宿	露營
家居	閒居	賦閑	蹲
居無定所	東奔西跑	東奔西走	東跑西顛
風俗	鄉規民約
停留	稽留	羈留	滯留	逗留	勾留	盤桓	棲息	停	待	留	悶	羈	棲	駐留
遷移	遷徙	搬遷	徙	遷	搬	動遷	外移
遷居	移居	喬遷	搬家	挪窩兒	喜遷
消磨	打發	虛度	泡	混	鬼混
度過	度	過	渡過	走過　
捱	熬	拖	度日如年	苦熬
虛度	蹉跎	虛度年華
經歷	經驗	閱歷	涉世	閱世	更	閱	曆	涉
親歷	躬逢
做壽	做生日	過生日
迎春	喜迎春
過節	逢年過節
獨立	自立	獨立自主	自主
自力更生	自食其力	自給自足	自給有餘	自力
依附	仰人鼻息	看人眉睫	身不由己	俯仰由人	寄人籬下
受制於人	受人牽制	任人宰割
隨大溜	隨群	隨俗	與時俯仰	與世浮沉	旅進旅退	人云亦云	隨波逐流	隨鄉入鄉
混日子	得過且過	做一天和尚撞一天鐘
吃閒飯	吃現成飯	素食	素餐	尸位素餐	無所事事	吃現成
依託	依賴
流浪	流蕩	漂泊	漂流	流轉	飄零	亂離	流離顛沛	顛沛流離	流離失所	飄泊	飄流	四海為家	浪跡天涯	浮生	萍蹤浪跡
流亡	逃亡	亡命	賁
投靠	投奔	投親靠友
奔波	奔走	奔忙	跑	跑前跑後	奔波如梭	鞍馬勞頓
走江湖	跑江湖	闖江湖	走南闖北	闖蕩江湖
操勞	累	勞累
抽空	偷空	偷閒	忙裡偷閒
發奮	奮發	奮勉	奮起	奮鬥	奮	鬥爭	努力	艱苦奮鬥	埋頭苦幹	奮起直追	奮發圖強	發奮圖強	發憤圖強	勵精圖治	聞雞起舞	拼搏	不可偏廢	振興圖強	圖強	奮發向上	奮爭	創優	奮起拼搏	力拼	硬拼	勇攀高峰	懋	奮發努力	下工夫	勱	加把勁	加油	衝刺
自勵	自勉	自強	自強不息	臥薪嚐膽
爭先創優	評先創優
荒廢	荒疏	拋荒	荒	廢	偏廢
興	振興
偷懶	躲懶	怠惰	偷閒
避難就易	避重就輕
偷生	偷安	苟活	苟且	苟全	苟安	苟且偷生	苟全性命
過繼	繼嗣	承繼
承繼	繼承	承受	承襲	襲	繼	傳承	代代相承
工作	幹活兒	做事	行事	辦事	視事	勞作	坐班	幹活
上工	上班	出勤	出工
共事	同事
單幹	唱獨腳戲
從業	在業
勞動	勞	服務	勞務
突擊	趕任務	開快車	加班	加班加點
怠工	磨洋工	消極怠工
打夜作	開夜車	挑燈夜戰	夜戰
跑腿兒	跑龍套	打雜兒	打雜	摸爬滾打
致富	脫貧致富
做	作	幹	辦	搞	打	弄	鬧	為	行	將	來	抓	施	整	整治	動手	下手	抓撓	折騰	施行	打出	肇	自辦	做做	力抓	勇為
辦好	做好	搞好	善	搞活	盤活	抓好	善為
辦成	辦到
施展	施	耍	玩
露一手	牛刀小試	大顯身手	大顯神通	大展經綸	八仙過海，各顯神通	小打小鬧	小試鋒芒	翻江倒海	大展宏圖	有所為有所不為	有所不為而後可以有為	一試身手
合作	協作	搭檔	搭夥	通力合作	經合	南南合作
嘗試	試行	試	碰	摸索	躍躍欲試	試跳	小試牛刀	試試	試試看	搞搞	躍躍一試
試工	試辦	試飛	試看
抱佛腳	臨時抱佛腳	臨渴掘井	臨陣磨槍
放馬後炮	賊去關門
趕浪頭	趕時髦	趕潮流
留後路	留後手	留餘地	留有餘地	留底	留一手
留後患	養虎遺患	養癰遺患	放虎歸山	後患無窮	縱虎歸山	養癰成患
效勞	效力	出力	報效	投效	效命	效死	賣命	效忠	盡忠	盡職	盡責	鞠躬盡瘁	克盡職守	死而後已
造福	謀福利	造福一方
發揚	恢弘	伸張	揚	發揚光大	弘揚
增光	光大	光前裕後	光宗耀祖	增色添彩	增光添彩
增色	生色	生光
玷污	玷辱	辱沒	污辱	辱	蠅糞點玉	褻瀆
補救	彌補	挽救	亡羊補牢
掙扎	掙命	垂死掙扎	困獸猶鬥
冒險	虎口拔牙	孤注一擲	鋌而走險	龍口奪食
拼命	玩兒命	豁出去	拼死拼活
守節	節烈
守身	守身如玉
變節	失節
從事	務	事	業	從	操	行	從業	轉產	轉業	專事	專司	致力
廁身	側身	存身	置身	投身	廁足
參加	加入	進入	投入	入夥	入	在	加盟
入席	就席	即席	就位	各就各位
混進	混入	混跡
脫離	脫	離	退	退夥	退出	淡出	洗脫	脫膠	剝離
退伍	退役
解脫	擺脫	超脫	脫出	出脫	開脫	脫身	抽身	蟬蛻	脫位
脫鉤	脫節
出席	列席	參加	到	與	到場	在場	到會	與會	在座	到庭	赴會	到位	臨場	在座
缺席	不到	缺陣
謀事	找事	求職	謀生路	謀職	求業
做工	做活兒	幹活兒
扛長活	扛活	攬工
打短工	打短兒	打零工
務農	種田	種地	犁地	種糧	農務
經商	做生意	賈
跑碼頭	跑單幫
任教	執教
行醫	從醫
參軍	從軍	從戎	入伍	吃糧	服兵役	當兵	服役	現役	戎馬	應徵
投筆從戎	棄文就武
出家	削髮	剃度	遁入空門
入行	出道
做官	從政	仕	宦
辭職	退職	告退	辭	捲舖蓋	辭去	辭卻
離職	去職	離任
引退	隱退	退隱	抽身	功成身退	解甲歸田	急流勇退	功成引退
退休	離休	告老	告老還鄉	退居二線	離退休
擔負	擔當	擔待	承擔	承當	承受	負擔	負責	肩負	擔	負	背	頂	當	荷	背負	承負	各負其責	頂住
承攬	兜攬	包攬	承包	包圓兒	攬	包	兜	三包	大包大攬	承修	包圓
擔任	充任	出任	充當	任	充	當	做	常任	勇挑重擔	擔綱
勝任	獨當一面	盡職盡責	不負
任職	供職
連任	連選連任
兼職	兼任	兼差	兼	一身兩役	兼顧
採集	收集	搜集	徵集	募集	採錄	採訪	採擷	采	集	募	編采	集萃	采采	擷	綜采	集粹	收載	籌募
搜羅	收羅	網羅	羅致	招致
挑選	揀選	精選	甄選	提選	挑揀	選擇	採擇	抉擇	摘取	選取	取捨	挑	選	揀	擇	摘	蔔	挑三揀四	披沙揀金	分選	慎選	增選	選項	挑挑揀揀	選料	選萃	求同求異	捎
選材	甄拔
擇友	擇交
抽樣	取樣
取長補短	截長補短	趨長避短	揚長避短	揚長補短	用長避短
觀察	觀測	察看	相	觀	察	體察	考察	審察	洞察	著眼	察言觀色	觀賽
綜觀	通觀	縱觀	縱論
展望	瞻望	向前看
看破	看穿	看透	透視
比較	比擬	比	較	比起	較之	同比	相形之下	可比
對比	對照	對待	相比	比照	比	相對而言	相比之下	自查自糾	對立統一
區分	區別	分別	分	別	有別於	有別	界別	組別	工農差別
辨別	辨明	分辨	辨	識別	判別	甄別	鑒別	辨認	甄	辨識	識假	可辨
判斷	斷定	判定	論斷	判明	判	認清	評斷	一口咬定	咬定	看清
開門揖盜	引狼入室
使用	應用	利用	採用	施用	運用	行使	役使	使役	使喚	動用	運	用	以	使	動	下	祭	採取	用到
自用	私用
享用	受用
零用	零花
用於	用來	用以
沿用	套用	襲用	蕭規曹隨
因循	因襲	沿襲	承襲	蹈襲	陳陳相因	率由舊章
照搬	生搬硬套	生吞活剝
借鑒	引為鑒戒	引以為戒	用人之長	聞者足戒	以此為戒	引以為鑒	有鑒於	後車之鑒	以史為鑒
稱	過秤	過磅	戥	磅	志	約	掂	稱量	稱稱
量	計量	比量	計計
丈量	丈	步
計算	划算	盤算	籌算	匡算	合算	算計	約計	計量	乘除	計	算	匡	貲	精打細算	測算	匯算	算算	打算盤
核算	核計
換算	折算
掐算	能掐會算	妙算
運算	演算
合併	合	並	拼	融為一體	拼制	並線	集成	合二為一	一統	合二而一	融會	並軌	購並	三合一	併入	合龍	合攏	合一
湊合	拼湊	東拼西湊	七拼八湊	併攏	拼接
分開	劃分	瓜分	分割	分	劈	分叉	細分	壓分	私分	撩撥	剪切	撤並	區劃	劈叉
平分	均分	平均	等分	四分開	分等
中分	平分秋色	一分為二	分片	分塊
分攤	分擔	分派	平攤	攤派	攤
分成	分為
出錢	出資	掏腰包	解囊	慷慨解囊	掏錢
籌集	湊份子
起床	起身	起來	下床
睡覺	睡	困	歇	安歇	上床	就寢	歇息	安息	寐	睡眠
小睡	打盹兒	打瞌睡	假寐	盹
午睡	歇晌
休息	休憩	歇息	喘息	停歇	喘氣	休	歇	息	喘喘氣	作息	歇歇
歇工	休工
乘涼	納涼	歇涼	涼快	涼
療養	將養	將息	休養	靜養	養病	調護	調治	養	體療
調養	保養	頤養	將養	養生	將息	調理	攝生	保健	消夏	安享	清心
補養	滋補	補	藥補
理髮	剃頭	推頭	整容
梳頭	梳理	梳	攏	櫛
燙髮	燙頭
刮臉	修面
打扮	裝扮	妝飾	化妝	美容	美髮
梳妝	梳洗	修飾
描眉	畫眉	描眉畫眼
整理	整	理	整治	拾掇	收拾	收束	摒擋	打點	疏理	盤整	重整	抉剔爬梳	規整
歸攏	歸著	歸	理順	歸集
整裝	治裝
料理	張羅	經紀	操持	調停	調理	理
準備	預備	備	未雨綢繆	備而不用	有備而來	備選	以防不測	備災
籌備	籌畫	籌措	張羅	籌	製備	籌組
攜帶	隨帶	拖帶	帶	攜	挈	牽	挾帶	帶走	帶入	攜家帶口	捎
拉家帶口	拖家帶口
跟隨	尾隨	隨從	跟	隨	踵	從	追隨	緊跟著	隨行
趕集	趕場
外出	出外	出門	出遠門	飛往	去往
出走	出奔	出亡
逃跑	逃走	逃脫	脫逃	逃遁	潛逃	逃逸	兔脫	逃匿	逃亡	亡命	逃	跑	遁	逸	奔	開小差	逃之夭夭	遠走高飛	望風而逃	落荒而逃	臨陣脫逃	金蟬脫殼	出逃	潛	潛流	亂跑	偷逃	虎口脫險	賁
潰逃	潰散
捲逃	席捲而逃
逃竄	竄逃	流竄	竄	抱頭鼠竄	逃奔
溜走	溜號	溜	溜之大吉	溜之乎也
逃命	逃生
逃離	逃出
躲藏	隱藏	掩藏	潛藏	暗藏	隱匿	藏匿	逃匿	藏身	匿跡	斂跡	掩蔽	隱蔽	潛伏	埋伏	打埋伏	隱伏	匿伏	匿	伏	影	藏	躲	匿影藏形	隱沒	隱身	東躲西藏	隱形
躲避	退避	畏避	閃避	閃躲	躲閃	閃	避
跟蹤	盯梢	釘	跟	釘住	盯住
追蹤	躡蹤	尋蹤
尋找	找尋	尋覓	摸索	搜索	搜尋	追尋	物色	踅摸	尋	找	覓	索	搜	摸	按圖索驥	查找	招來	追覓	查尋	搜求	探尋	找找	檢索
翻箱倒櫃	傾箱倒篋
儲藏	貯藏	收藏	珍藏	保藏	藏	油藏	館藏	歸藏	窖藏	深藏	歸藏	整存
堅壁	堅壁清野
儲備	貯備	存貯	褚
儲存	貯存	貯	積存	囤	囤積	倉儲	存儲	收儲	專儲	蘊藏
保存	封存	保留
歸檔	存檔
庫藏	庫存
儲蓄	儲	存款	存	攢	聯儲	儲貸
縫紉	縫	綴
繃	緝	繰	釘	繚	沿	吊	鎖	絮
縫補	修補	織補	補	補綴	縫縫連連	補補	縫縫補補	修修補補
刺繡	繡花	紮花	繡	挑	挑花
滾邊	沿邊兒
紉針	穿針
曬	晾	曝	晾曬	曝曬
熨	燙	烙
點燈	掌燈	上燈	點火	明燈
燒火	點火	生火	籠火	打火	鑽木取火	燃爆
點燃	燃點	點	燃	焚	生	放	引燃	燃放
燒化	焚化	火化
加熱	燒	熬	燉	燙	暖	溫	篩	熱	加溫
烘	焙	烘焙	炮	烙	焐
取暖	暖	悟	暖和
燒火	著火
烹飪	烹調	烹	烹製
掌勺兒	掌勺
做飯	起火	炊	下廚	煮飯
烹茶	泡茶
炒	煎	煸	炮	烹	做菜	小炒
炸	氽
烤	炕	燔	炙	烘制
煮	燒	咕嘟	熬	燉	燜	煨	燴	臥	扒	悶	溜
熬	餷	煲
氽	熗	涮	焯
蒸	烀
拔絲	拉絲
回鍋	回爐	回籠	餾
品嘗	品味	嘗試	嘗	品	咂	遍嘗	嘗嘗
嘗新	嘗鮮
點饑	點心	點補	墊補
充饑	果腹
用餐	就餐	進餐	吃飯	進食	用	偏	用膳	開飯
下飯	佐餐
吃素	素餐	素食
吃葷	肉食	打牙祭
偏食	挑食
餵食	哺	喂
哺乳	餵奶	奶
會餐	聚餐
設宴	宴請	請客	饗客	大宴賓客	饗	接風洗塵
做東	作東
接風	洗塵
敬酒	勸酒
猜拳	劃拳	打通關
展覽	展出	展
欣賞	玩賞	觀賞	賞鑒	鑒賞	賞玩	玩味	玩	賞	含英咀華	觀瞻	賞析
遊戲	遊玩	遊藝	遊樂	娛樂	玩耍	戲耍	嬉戲	玩	耍	打	戲	好耍	玩樂	一日游	休閒游	紀遊	玩玩	娛	怡然自樂	嬉水	打鬧	嬉	逗逗樂樂	自樂
捉迷藏	藏貓兒
猜謎兒	破謎兒	猜謎
遊覽	遊歷	巡禮	登臨	巡遊	旅遊	出遊	雲遊	漫遊	暢遊	遊山玩水	遨遊	周遊	環游	出境游	國旅	觀光
郊遊	踏青	春遊	野營	遊園	城鄉游	三峽遊
消遣	清閒	排遣	自遣	排解	解悶	散悶	散心	消	消閒
遊蕩	遊逛	閒逛	閒蕩	逛蕩	轉悠	逛	遊	逛逛	敖
行樂	取樂	作樂	尋歡作樂	聲色犬馬
抽籤	抓鬮兒	拈鬮兒
戀愛	相戀	談戀愛	談情說愛	婚戀
鍾情	一見鍾情
追求	求偶	追	言情
求婚	求親	提親
調情	吊膀子
偷情	偷香竊玉	竊玉偷香
約會	幽會	幽期	花前月下
訂婚	訂婚	定親	攀親	受聘
許配	許	配	字
結婚	婚	成婚	婚配	完婚	成親	安家	成家	結合	拜天地	辦喜事	洞房花燭	喜結連理
新婚	新婚燕爾
聯姻	締姻	通婚	結親	換親	匹配	喜結良緣	男婚女嫁
娶	娶親	討親	迎娶
續弦	納妾
嫁	出嫁	嫁人	出閣	出門子	過門	聘	妻	嫁娶
改嫁	轉嫁
再嫁	再婚
入贅	上門	招女婿	招親	招贅	贅	倒插門
離婚	離異	離
退婚	退親
自殺	自盡	尋死	作死	自戕	自裁	輕生	自尋短見	尋短見	自決	自絕
自刎	抹脖子	刎
上吊	吊死	懸樑	自縊
投河	投井
治喪	喪葬	辦喪事
弔喪	弔孝	弔唁	奔喪
大殮	裝殮	入殮	收殮	殯殮	殮
出殯	殯葬	發送
送殯	送喪	送葬	執紼
安葬	埋葬	下葬	土葬	入土	入土為安
火葬	火化
海葬	水葬
陪葬	殉葬	殉	隨葬
戴孝	穿孝	帶孝
掃墓	上墳	祭掃
瞻仰	參謁	參見	拜謁	謁	饗
祭祀	祭	祀	祝福	祭天	祭拜	臘
祭奠	祭	奠
生事	鬧事	惹事	肇事	滋事	啟釁	搗亂	搗蛋	點火	放火	作怪	作惡	鬧鬼	找麻煩	惹是生非	無事生非	造謠生事	無理取鬧	小丑跳樑	群魔亂舞	興妖作怪	為非作歹	無所不為	興風作浪	掀風鼓浪	唯恐天下不亂	招事	撒野	擾民	惹麻煩	惹事生非	添亂	作亂	作祟
蠢動	蠢蠢欲動
挑釁	尋釁	找上門	釁尋滋事
胡鬧	胡來	胡攪	亂來	胡攪蠻纏	造孽
肆行	胡作非為	膽大妄為	肆無忌憚
捏造	編造	假造	捏合	杜撰	虛構	編	造	無中生有	胡編
冒充	假冒	假充	混充	作假	作偽	冒牌	冒	頂	充	以假亂真	魚目混珠	掛羊頭賣狗肉	打腫臉充胖子	偽造	充數	濫竽充數	冒用	制假	售假	賣假	冒領	以假充真	販假	仿冒	冒頂
冒名	假託	偽託	假借	僭	冒名頂替	假公濟私	借此	盜名欺世	矯
沽名釣譽	欺世盜名	欺世惑眾
炫耀	誇耀	顯耀	炫示	顯示	顯露	顯擺	擺	炫	自詡	咋呼	搬弄	表現	標榜	自我標榜	出風頭	招搖過市	賣弄	詡	抖威風	大出風頭	諞
邀功	邀功請賞
擺闊	擺攤子	擺闊氣
擺門面	擺樣子	裝門面	裝潢門面	擺譜	耍排場
撐場面	撐門面
擺架子	拿架子	搭架子
逞能	逞強	逞英雄	逞
賣乖	賣弄聰明	自作聰明
班門弄斧	布鼓雷門
逞性	任性	任意	使性子	耍脾氣	鬧脾氣
感情用事	意氣用事
拾荒	撿破爛兒
乞討	討乞	行乞	要飯	討飯	乞食	乞	討
上來	上去	上
蜂擁而上	一哄而上	一擁而上
下去	下來	下
來	來到	到來	過來	到	蒞	至	臨	來臨	駛來	趕到	趕來
蒞臨	降臨	惠臨	光臨	駕臨	賁臨	親臨	光顧	惠顧	屈駕	慕名而來	不期而至	翩然而至	乘興而來	遠道而來	隨之而來
接踵而來	源源而來	紛至遝來	蜂擁而來	接踵而至
去	過去	往	奔	前往	前去	造	之	赴	通往	徊	轉赴	踅
開往	開赴	奔赴	趕赴	趕往
一怒而去	拂袖而去	拂衣而去
來去	來回	來往	過往	往返	往復	往來	來來往往	老死不相往來	來回來去	回返
出	出來	出去	下	沁
進	進入	進來	進去	上	登	入	躋身
流入	流	注入	漸	滲
升堂入室	登堂入室
出入	進出
進出境	入出境
弄錯	失誤	疏失	出錯	離譜	錯	擰	串	差	一差二錯	陰錯陽差	陰差陽錯	鑄成大錯
失言	失口	走嘴	說走嘴
魯魚亥豕	魯魚帝虎
點金成鐵	畫蛇添足	畫虎類狗
失職	瀆職	怠忽職守
犯規	犯禁	違禁	違章
混淆	攪混	攪亂	淆亂	模糊	歪曲	張冠李戴	指鹿為馬	混淆是非	混淆黑白	習非成是	混為一談	混淆視聽
澄清	弄清	正本清源	闢謠	澄	搞清	疏淤	清淤
顛倒	顛倒是非	顛倒黑白	倒果為因	本末倒置	捨本逐末	輕重倒置	明珠投暗	剖腹藏珠	舛
反客為主	喧賓奪主
篡改	歪曲	曲解
改正	糾正	糾	正	改	撥亂反正
糾偏	補偏救弊	矯正
改過	悔過	改悔	回頭	改過自新	悔過自新	改邪歸正	棄邪歸正	棄暗投明	棄舊圖新	痛改前非	脫胎換骨	洗心革面	翻然悔悟	知過必改	洗手不幹	迷途知返	敗子回頭	回頭是岸	今是昨非	改過遷善	糾章	自糾	力矯	自查自糾
真假	真偽	真真假假
前進	邁進	進	上	向前	進發	邁入	前行	一往直前	無止境	永往直前	上前
乘風破浪	長風破浪	破浪前進
闊步前進	昂首闊步
並進	齊頭並進
後退	退	退回	退走	退卻	卻步	倒退	退縮	退避三舍	打退堂鼓	退後
追趕	追逐	追逼	尾追	追	趕	攆	你追我趕	迎頭趕上	趕超	趕上	急起直追	窮追	競逐
禱告	祈禱	禱	彌撒	彌散	祈願	祈福
禮拜	頂禮膜拜
跪拜	禮拜
祝福	賜福
朝覲	朝聖	巡禮	朝拜
拜佛	敬奉	供奉
燒香	焚香
齋戒	吃齋	齋
念經	誦經	念佛	講經說法
修行	修道	苦行	尊神
傳教	傳道	佈道	說教	說法
募化	化緣	化
佈施	施捨	施	舍	齋	嗟來之食
煉丹	點化
測字	拆字
看相	相面
圓夢	占夢
占卜	占	蔔	筮
占卦	算卦	卜卦
打醮	醮
保佑	庇佑	呵護	蔭庇	佑
檢舉	揭發	告發	告密	報案	舉報
彈劾	參
控告	告狀	指控	控	告	狀告	控訴
上告	上訴
喊冤	叫屈	申冤	申雪	喊冤叫屈	抗訴
誣告	誣
訴訟	詞訟	打官司	訟	辭訟
自首	投案
招認	供認	認罪	供認不諱	交待
招供	自供	坦白	供	招	交代	不打自招	鬆口
搜查	抄家	搜	抄	查抄
搜身	抄身
拘留	羈留	扣留	羈押	收押	拘禁	拘押	扣押	關押	看押	管押	在押	羈押	扣	看	押	圈	縶	禁閉	關禁閉	吊扣	扣壓
囚禁	監禁	幽禁	幽閉	收監	禁錮	囚	幽	被囚	監繳	身處牢籠
軟禁	幽禁	幽閉
勞改	勞動改造	勞教
逮捕	拘捕	緝捕	搜捕	追捕	捉拿	捉住	捕拿	緝拿	通緝	拘	抓	逮	捉	捕	緝	辦案	逋	抓捕	拘役	查扣	圍捕	拘傳	批捕
拿獲	捕獲	緝獲	破獲	一網打盡	抓獲	抓走	擒獲
押送	解送	押解	押	解	扭送	密押
釋放	開釋	假釋	保釋	獲釋	自由	釋	放	縱	出獄	放出	刑滿釋放	放活	放走	放飛	刑釋解教
審訊	審問	訊問	鞫問	鞫訊	問案	審案	審	訊	鞫	升堂
複審	再審
審理	審判	斷案	判案
提審	傳訊
開庭	過堂
刑訊	拷問	打問	逼供	屈打成招
判決	裁判	裁定	裁決	裁斷	宣判	公判
判罪	論罪	坐	定罪	判處	判刑
定案	定責
量刑	處刑
懲辦	法辦	查辦	究辦	懲處	懲治	懲罰	處治	處置	發落	治罪	收拾	懲治	辦	處	繩之以法	繩之以黨紀國法	處以
嚴懲	重辦	嚴懲不貸
懲戒	懲前毖後	懲一警百	殺一儆百	殺雞嚇猴	以一警百	懲一儆百
上刑	動刑	用刑	嚴刑	拷打
淩遲	剮
車裂	五馬分屍
支解	磔
滅族	夷族	族	株連九族
沒收	充公	抄沒	罰沒
查封	封閉	封	封門
剝奪	褫奪	奪	禁用
遊街	示眾
充軍	發配	刺配	流放	放逐	放	配	流	下放	放流
償命	抵命
處決	正法	行刑	鎮壓	殺	明正典刑	臨刑	處死
槍斃	槍決	斃	崩	斃傷
斬首	殺頭	開刀
赦免	大赦	特赦	赦	貰
免罪	免刑	免責
違法	犯法	犯罪	犯案	作案	不軌	作奸犯科	違法亂紀	以身試法	違紀	圖謀不軌	冒天下之大不韙	玩火
枉法	貪贓枉法	徇私枉法	有法不依
知法犯法	執法犯法	明知故犯
放火	縱火
綁架	綁票	架	劫持
持機	劫機
搶劫	打劫	行劫	劫掠	搶掠	搶奪	掠奪	劫奪	攘奪	擄掠	掠取	攫取	搶	掠	劫	奪	擄	打家劫舍	殺人越貨	奪走	爭搶	搶走	拼搶	強取豪奪
路劫	斷路
洗劫	洗劫一空	哄搶	一搶而空	劫掠一空
趁火打劫	趁人之危
盜竊	偷竊	行竊	偷盜	偷	盜	竊	順手牽羊	小偷小摸	監守自盜	扒竊	盜伐	盜打	盜掘	盜取	盜走	竊走	偷走
鼠竊狗偷	偷雞摸狗
窩贓	窩藏
分贓	坐地分贓
殺死	殺	誅	殛	結果	剌	幹掉	弑
殺害	兇殺	行兇	滅口	殘殺	殘害	下毒手	殺人越貨
活埋	坑
下毒	放毒	毒殺
自相殘殺	自相殘害	自相魚肉
暗殺	刺殺	行刺	刺	幹
屠殺	殺戮	屠戮	屠	血洗	劈殺	大屠殺
狎妓	嫖妓	嫖娼	嫖	逛窯子	尋花問柳	拈花惹草	偷香竊玉	竊玉偷香	問柳尋花
賣淫	賣身	招蜂引蝶
通姦	私通	姘居	同居	苟合	奸	通	偷人
姦污	姦淫	強姦	誘姦	雞奸	奸
調戲	玩弄	猥褻
賭博	賭錢	耍錢	賭	博
壓	壓寶	投注
抽頭	打頭
鑽營	鑽謀	運動	活動	走內線	走後門	鑽門子	蠅營狗苟	上供
賄賂	行賄	賄買	打點	收買	買通	賄金	賄	公賄	賄選	賂
受賄	納賄	貪贓	貪贓枉法	中飽私囊	受惠
舞弊	作弊	做手腳	營私舞弊	徇私舞弊	上下其手	營私
徇私	徇情	開後門	以權謀私	放水	貓兒膩
剽竊	剽取	抄襲	剿襲	抄	依葫蘆畫瓢
侵吞	吞沒	侵佔	強佔	搶佔	侵奪	併吞	鵲巢鳩佔	巧取豪奪
克扣	揩油
敲詐	訛	詐	勒索	敲	訛	敲竹槓	敲詐勒索	訛詐
打秋風	秋風	抽風	坑蒙拐騙
拐騙	拐帶	誘拐	拐	坑騙
詐騙	詐	行騙	騙
剝削	盤剝	敲骨吸髓	宰客
搜刮	搜括	壓榨	榨取	斂財	聚斂	刮	摟	刮地皮	橫徵暴斂	壓迫
投機	投機倒把	買空賣空
渾水摸魚	撈
囤積	囤	囤積居奇
走私	走漏	走私販私
天亮	發亮	拂曉	破曉	天明	亮	旭日東昇
日上三竿	晴好
天暗	天黑	夜幕低垂	遲暮
夕陽西下	日薄西山
晴	晴朗	明朗	清朗	爽朗	清明	晴和	晴空萬里	萬里無雲	光風霽月	晴天	天高氣爽	響晴	月明風清	晴到少雲	陰轉多雲
風和日暖	風和日麗	春光明媚
放晴	霽	雨過天晴	雲開日出	雲消霧散
陰	陰暗	陰沉	陰沉沉	陰霾	靄靄	密雲不雨	天昏地暗	陰天	陰間多雲	晴到多雲
颳風	起風
拂面	撲面	習習
蕭蕭	蕭瑟	春風料峭
狂風怒號	飛砂走石	山雨欲來風滿樓	飛沙走石
下雨	降雨	降水	掉點兒	天公不作美	天不作美	普降
滂沱	霈	大雨如注
風狂雨驟	暴風驟雨
風雨交加	風雨如磐	風風雨雨	風雨淒淒	淒風苦雨
雨天	下雨天
下雪	大雪紛飛	降雪
風雪交加	風雪
降霜	霜降
打閃	閃電
打雷	霹靂	雷鳴	雷電交加	雷轟電閃	雷鳴電閃	雷電
起霧	霧濛濛	霧氣騰騰	霧騰騰
冒煙	濃煙滾滾	煙霧彌漫
起浪	波濤洶湧	波濤滾滾	驚濤駭浪	洪流滾滾	波濤滾滾	洶湧澎湃	怒濤澎湃
照射	投射	映射	映照	照耀	炫耀	照臨	輝映	照	射	耀	投
照亮	照明	燭照	燭	生輝
光照	普照	日照
反射	反照	照	映	反光	相映成輝	倒映
輻照	輻射
交相輝映	暉映
照見	映出
折光	折射
發光	發亮	煜
閃光	閃亮	閃爍	閃耀	忽閃	爍爍	忽明忽暗	熠熠閃閃	閃爍生輝	光閃閃
金光閃閃	金閃閃
作響	響	鳴	作	嗚咽	響起	叮噹	鼓樂齊鳴
轟	轟鳴	吼	號	呼嘯	嘯鳴	咆哮	巨響
爆炸	爆裂	放炮	炸
炸毀	炸裂	炸掉
核爆炸	核爆
燃燒	焚燒	燃	燒	燔	焚	著	灼
燒毀	焚毀	付之一炬
焦	燎	糊
沸騰	開鍋	開	沸	滾	喧	滾沸
蒸發	揮發	跑	飛	走	亂跑
溶解	溶化	溶
融化	溶化	融解	融	消融	化	烊	融注	化入	溶入	溶溶
冷卻	冷	涼	激	鎮	製冷	降溫	氣冷
結冰	凍結	上凍	冰凍	凍	冷凝	封凍	凝凍	冷凍
解凍	化凍	開河	開化	開
腐爛	腐敗	腐化	腐朽	爛	朽	敗	腐	糜爛	朽爛
發黴	黴	黴爛	酡
變質	餿	壞
生銹	鏽
褪色	落色	脫色	掉色	走色	退色
生育	生產	生養	生	產	養	生兒育女	添丁
孿生	雙生
足月	待產
分娩	分身	臨盆	臨產	分蘖
坐月子	坐蓐
流產	小產
生於	出生於
誕生	出生	降生	生	落地	墜地	出世	落草
生長	見長	生	長	發育
成長	長進	成人	成材	成才
出挑	出脫	出落	出息
長成	長大
繁殖	生殖	殖	滋生	生息	蕃息	繁衍	傳宗接代	增殖
下	生	產	產卵	下蛋
孵	抱	抱窩	孵化	孵卵	孚
發胖	發福
活	生	生活	生存	在世	健在	存	在	活著
回生	生還
死	亡	故	卒	弱	逝	歿	殪	斃	殂	殞	薨	死亡	亡故	身故	物故	物化	去世	逝世	故世	謝世	棄世	過世	下世	凋謝	斃命	殞命	殞滅	殂謝	長逝	永訣	永別	長眠	故去	斷氣	咽氣	合眼	閉眼	完蛋	嗚呼	回老家	玩兒完	翹辮子	上西天	粉身碎骨	與世長辭	溘然長逝	壽終正寢	命赴黃泉	嗚呼哀哉	一命嗚呼	死去	氣絕身亡	辭世	已故	碎骨粉身	撒手人寰
仙逝	千古	作古	歸西	歸天	過去	不諱	跨鶴西遊	三長兩短	山高水低	病故	病逝
犧牲	捨身	獻身	就義	捐軀	殉職	殉國	殉難	殉節	殉	效死	效命	授命	陣亡	殺身成仁	捨生取義	馬革裹屍	肝腦塗地	為國捐軀	以身殉職	死而後己	自我犧牲	成仁	捨死忘生
橫死	凶死	喪命	送命	斃命	暴卒	死於非命	沒命	喪生	身亡	喪身
升天	坐化	羽化	物化	圓寂
夭折	夭亡	早逝	殤	蘭摧玉折	夭	英年早逝
半死	瀕死	一息尚存
醒	睡醒	蘇醒	清醒	覺	寤	蘇	醒來	複明
入睡	入夢	入眠	成眠	安眠	睡著	著	入夢鄉
沉睡	熟睡	睡熟	鼾睡	酣睡	酣夢	酣然
休眠	眠	蟄伏
瞌睡	打盹
失眠	輾轉反側	目不交睫	夜不能寐	寢不安席
飽	打飽嗝兒
餓	饑	餒	饑餓	挨餓	餓飯	食不果腹	饑腸轆轆	嗷嗷待哺	喝西北風
渴	幹	焦渴	乾渴	舌敝唇焦	口渴
饞	嘴饞	貪嘴	貪吃	饕	饕餮	饞涎欲滴	垂涎欲滴
醉	醺
酩酊	醉醺醺	酩酊大醉	爛醉如泥
打嗝兒	噯氣	呃逆	飽嗝兒	呃	嗝兒
噴嚏	嚏噴
打呵欠	打哈欠	哈欠	呵欠	微醺
大便	大解	拉屎	出恭
便秘	下泄
小便	小解	撒尿	起夜	排泄	泌尿
尿床	尿炕	遺尿
癃	閉	癃
解手	淨手	更衣	便溺	屙	拆	大小便	上解
出汗	流汗	淌汗	揮汗	汗津津	汗流浹背	揮汗如雨	滿頭大汗	冒汗	大汗淋漓
盜汗	出冷汗
行經	來潮	便血
性交	交媾	雲雨	同房	人道	行房
交配	交尾	配對	雜交
遺精	夢遺
懷孕	懷胎	有喜	妊娠	有身子	大肚子	身懷六甲	孕
受孕	受胎	受精
生病	害病	有病	鬧病	患病	得病	受病	染病	抱病	扶病	臥病	病	害	患	病倒	患有	久病	身患	致病	帶病	病魔纏身	年老多病
不適	不快	難受	難過	不爽	不得勁	沉	無礙
犯病	發病	犯節氣
欠安	不安
病重	病篤
病危	危篤	危重	危殆	彌留	病入膏肓	氣息奄奄	奄奄一息	行將就木	命在旦夕	朝不保夕	凶多吉少	九死一生	萬死一生
垂死	垂危	瀕危	臨危	臨終
受傷	負傷	掛花	掛彩
遍體鱗傷	體無完膚	皮開肉綻	重傷
扭	蹩	閃	崴
燒傷	灼傷	燒灼
傷亡	死傷
殺傷	刺傷
病癒	痊癒	大好	康復	起床	霍然	愈	痊	好	藥到病除	治癒
好轉	見好	有起色	回春
收口	合口	癒合	傷癒
復活	還魂	複生	起死回生	死而復生
癢	癢癢	刺癢	刺撓	瘙癢	發癢
酸	酸軟	酸溜溜
痛	疼	疼痛	火辣辣	生疼	觸痛	作痛	隱隱作痛
心絞痛	狹心症
腫	膀	浮腫	水腫	腫大
脹	發脹	腫脹	鼓脹	水臌	氣臌	頭昏腦脹	腹脹	滯脹
食積	存食
消化	克	化
咳	咳嗽	乾咳
吐	嘔吐	噦	嘔	唚
孕吐	害喜	胎氣
吐血	嘔血	咯血
瀉	腹瀉	水瀉	拉稀	瀉肚	跑肚	鬧肚子	拉肚子	下瀉
著涼	受涼	傷風	著風	感冒	受寒
受暑	受熱	發痧
發燒	發熱	發寒熱	燒	發高燒
高燒	高熱
頭昏	昏	暈	昏亂	昏沉	昏眩	頭暈	眩暈	迷糊	暈乎乎	昏頭昏腦	昏天黑地	暈頭暈腦	暈頭轉向	天旋地轉	眼冒金星	騰雲駕霧	發昏	發懵	頭暈眼花	頭暈目眩
昏沉沉	昏昏沉沉
眼花	昏花	目眩	霧裡看花	看朱成碧	頭昏眼花
休克	虛脫	窒息
昏迷	昏倒	暈倒	昏厥	暈厥	痰厥	蒙	不省人事	昏迷不醒
譫妄	說胡話
抽搐	抽搦	搐縮	抽縮	抽風	抽筋	抽	轉筋	痙攣	搐搦
麻木	發麻	酥麻	不仁	麻痹	麻	木	麻酥酥	麻木不仁
癱瘓	風癱	癱	截癱	偏癱	半身不遂	腦癱
單癱	下痿	瘛
發瘋	發狂	瘋癲	癲狂	瘋狂	瘋	狂	癡	癲	發神經	神經錯亂	瘋顛顛	瘋了呱幾
心悸	心跳	怔忡	驚悸
貧血	血虧
梗塞	栓塞	堵塞	哽	壅塞
腸梗阻	腸阻塞	腸套疊
出血	衄	血崩	崩漏	血流如注	流血	大出血
化膿	潰爛	潰
啞	喑	喑啞	沙啞	倒	失音	倒嗓	嘶啞
聾	背	聵	耳背	失聰	重聽	耳沉
瞎	失明	盲	眇	瞎眼
口吃	結巴	磕巴	謇	期期艾艾
駝	駝背	佝僂	水蛇腰	僂
跛	瘸	拐	蹇	跛足
開花	開放	綻	開	放	吐蕊	綻出	爭芳鬥豔	百卉吐豔	群芳爭豔	綻開	綻放	裡外開花	怒放	盛開
結果	結實	結出	結莢
凋謝	萎謝	凋落	凋零	零落	衰落	衰敗	枯萎	枯槁	萎縮	萎蔫	蔫	謝	凋	敗	枯	萎靡
吐穗	抽穗	秀	孕穗	打苞
受粉	受精
發芽	抽芽	出芽	滋芽	萌芽	萌動	萌發	吐綠	萌
成熟	熟	稔	秋
笑	樂	歡笑	笑笑
大笑	絕倒	噴飯	哄笑	狂笑	噱	哈哈大笑	仰天大笑	前仰後合	捧腹大笑	哄堂大笑	哄然大笑	大笑不止	開懷大笑	欲笑無聲
微笑	莞爾	哂	粲然一笑	嫣然一笑	眉歡眼笑	滿面笑容	面帶微笑
發笑	失笑	忍俊不禁
苦笑	乾笑	強顏歡笑
暗笑	竊笑
奸笑	皮笑肉不笑	笑裡藏刀
諂笑	脅肩諂笑
憨笑	傻笑	傻樂	哂笑
笑哈哈	笑呵呵	笑眯眯	笑嘻嘻	笑盈盈	笑吟吟
嬉皮笑臉	嘻嘻哈哈	嬉笑
含笑	笑容滿面	笑容可掬	眉開眼笑	喜眉笑眼	笑顏逐開
哭	啼哭	啼	哭鼻子	哭哭啼啼	哭喪著臉
號	號哭	呼號	哀號	聲淚俱下	號啕大哭	痛哭流涕	呼天搶地	哭天哭地	哭天抹淚	如喪考妣	啼饑號寒	鬼哭神嚎	鬼哭狼嚎	哭喊	哭叫	哀呼	哭喪	如訴如泣	抱頭痛哭	如泣如訴
泣	哭泣	飲泣	啜泣	涕泣	抽泣	抽噎	抽搭	哽咽	幽咽	嗚咽	吞聲	飲泣吞聲	悲泣	盈眶
流淚	揮淚	灑淚	涕零	聲淚俱下	落淚	潸然淚下
淚如泉湧	淚如雨下	以淚洗面	淚痕斑斑	老淚橫流	老淚縱橫	淚流滿面	痛哭
含淚	淚汪汪	珠淚盈眶	熱淚奪眶	熱淚盈眶
害臊	害羞	含羞	怕羞	靦腆	羞人	羞澀	羞怯	嬌羞	羞	臊	忸怩	抹不開	羞答答	羞人答答	羞羞答答	不好意思
紅臉	臉紅	紅潮	赧顏	赧然	面紅耳赤	臉皮薄
沒羞	不害羞	臉皮厚	好意思	涎著臉	老著臉皮	死皮賴臉	涎皮賴臉	死乞白賴	恬不知恥	不知人間有羞恥事
賣俏	搔頭弄姿
傳情	眉目傳情	脈脈傳情	眉來眼去	暗送秋波
撒嬌	發嗲	扭捏
嬌滴滴	嗲聲嗲氣	嬌裡嬌氣
歎氣	歎息	太息	嗟歎	興歎	歎	噓	唉聲歎氣	長籲短歎	唉聲嘆氣
長歎	浩歎	仰天長歎
悲歎	哀歎
慨歎	喟歎	感慨	感歎	慨然	感慨萬端	感慨不已	感慨萬千	感慨萬分
發呆	發愣	愣神兒	出神	木然	傻眼	呆	愣	眼睜睜	直勾勾	乾瞪眼	呆若木雞	泥塑木雕	木雕泥塑	張口結舌	瞠目結舌	目瞪口呆	直眉瞪眼	發楞	發傻	愣住	愣神	緘口結舌
沉默	默然	靜默	緘默	默	默默無言	默默不語	默不作聲	沉默寡言
不做聲	悶頭兒	緘口	絕口	不聲不響	不言不語	不哼不哈	閉口無言	啞口無言	一言不發	一聲不響	不贊一詞	欲言又止	三緘其口	噤若寒蟬	無言以對
振奮	振作	抖擻	飽滿	旺盛	充沛	煥發	風發	奮發	上勁	來勁	起勁	帶勁	神氣	精神	精神百倍	神采奕奕	生龍活虎	生氣勃勃	朝氣蓬勃	鼓足	動感	群情激奮	精精神神
激發	鼓	抖	打	激
激昂	激揚	昂揚	高昂	昂然	昂昂	慷慨激昂	激昂慷慨	拍案而起	壯志淩雲	意氣風發	有神	精神抖擻	精神煥發	容光煥發	神采飛揚	雄赳赳	氣昂昂	壯懷激烈	鬥志昂揚
疲倦	疲勞	疲乏	倦	疲	乏	懶	累	困	困乏	困頓	困倦	勞累	疲憊	困憊	慵懶	疲頓	委頓	疲竭	疲軟	精疲力盡	憊	勞乏	累人	悶倦	乏力	瘁	嗜睡	累死	憂困	虛弱不堪	疲弱	疲態
風塵僕僕	僕僕風塵	人困馬乏	疲憊不堪	精疲力竭	力盡筋疲	聲嘶力竭
懶散	懨懨	蔫	蔫不唧	懶洋洋	沒精打采	有氣無力	精神不振	軟弱無力
頹唐	萎靡不振	垂頭喪氣	暮氣沉沉	死氣沉沉	死沉	蔫頭耷腦
板臉	繃臉
瞪眼	怒目	橫眉怒目
喘息	氣短	氣急	氣咻咻	氣吁吁	氣喘吁吁	上氣不接下氣	喘噓噓	喘喘氣
氣喘	哮喘	喘氣	喘	痰喘
屏氣	屏息	屏
假裝	偽裝	裝作	作偽	裝假	假充	佯裝	裝	作	佯	詐	弄虛作假	裝做
做作	扭捏	裝蒜	裝腔	裝相	裝樣子	裝腔作勢	裝模作樣	惺惺作態	東施效顰	故作姿態	拿腔作勢	拿腔拿調	矯揉造作	無病呻吟	一本正經	假模假式	捏腔拿調	虛飾	嬌揉造作
裝傻	裝瘋賣傻	裝糊塗
假死	佯死	詐死	裝死	裝熊
翹	蹺	企	抬	昂	仰	撅
懸	蕩
垂	下垂	低垂	低下	放下	墜	俯	拖	耷拉	懸垂
披	披散
凸起	隆起	突起	突出	鼓起	崛起	暴	鼓鼓的	鼓鼓
凹陷	陷	陷落	塌陷	穹形
裸露	赤露	袒露	曝露	袒	露	赤	光	光溜溜	敞露	外露	裸	赤裸	赤身露體	露出
裸體	赤裸裸	赤條條	精光	赤身裸體	一絲不掛
赤膊	赤背	打赤膊
赤腳	赤足	打赤腳	科頭跣足
遮蓋	掩蓋	覆蓋	被覆	蓋	覆	蒙	掛	罩	埋	掩	蔽	蒙面	遮住	披蓋	庇	遮蔭	冪
遮擋	遮蔽	障蔽	蔭蔽	遮罩	遮藏	遮掩	蔭	遮	擋	翳	擋住	擋風遮雨	遮風擋雨	遮光
籠罩	籠
伸	引	延	伸進	奮翅展翼
展	伸展	展開	張	鋪展	舒展	舒張	張大	拓
直	挺直	伸直	梗
挺	腆
縮	收縮	收攏
蜷縮	攣縮	瑟縮	龜縮
伸縮	舒卷
張合	翕張
落下	落	掉	掉落	墮	跌	跌落	墜落	跌入	墜入	倒掉	一瀉而下	花落花開	打落
倒塌	坍塌	塌架	崩塌	傾倒	倒下	傾覆	坍	塌	垮	傾	圮	潰
塌方	坍方
天塌地陷	天坍地陷
損壞	弄壞	破壞	毀壞	毀損	毀傷	壞	毀	摔	磨損	毀掉
裂開	裂	分裂	破裂	開綻	龜裂	裂縫	裂口	坼	繃	豁	綻	披	皴	綻裂	開裂	踏破	皴裂	凍裂	崖崩	皸裂	乾裂	顎裂
爆裂	迸裂	崩裂	崩	炸	爆	炸掉
折斷	斷裂	斷	折
聳立	矗立	壁立	陡立	挺立	屹立	獨立	直立	矗	峙	聳	屹	堅挺	高矗
停放	放置	停	放
寄放	存放	寄存	存	存放在
懸掛	吊	掛	懸	吊放	浮吊	高懸	懸垂	掛到	昂立	吊起
顛倒	倒
陳列	陳放	羅列	擺	陳	位列	列支	班列
佈置	陳設	擺設	擺佈	擺	張	擺放	佈陣
排列	排	列	平列
列為	名列	排定
分佈	散佈	布	遍佈
堆積	堆	積	積聚	堆放	堆積如山
淤積	沉積	沖積	淤	淤積物
散落	灑	撒	落	天女散花
澆	淋	浞	打	澆水	沐
濺	迸	澎	飛濺	迸射
噴	噴射	噴濺	噴發	射	唧	滋	迸發	高射	噴灑	噴塗	噴湧
溢	漫	漾	漫溢	氾濫	溢出	湧	浩	滔
滴	瀝	淋漓	滴答	滴滴答答
泡	浸	浸泡	浸漬	浸入
淹	淹沒	滅頂	溺水
沉	沒	下沉	擊沉	沉底	下移	降下	下浮
陷	下陷	沉陷	沉陷	沉沒	陷落	沉澱	沉井	沒頂	陷沒
漂	浮	泛	氽	浮動	浮泛	漂浮	懸浮	漂流	漂移	飄蕩	飄忽	浮游	飄浮	上浮
磁懸浮	磁浮
流	流動	流淌	淌	注	橫流	綠水長流
奔瀉	傾瀉	奔流	湧流	瀉	傾注	奔湧	澤瀉	湧動	流下	一瀉而下	流瀉
潺潺	涓涓
翻騰	翻滾	滾滾	沸騰	滕	滔天
飄	飄揚	飄灑	飄蕩	浮蕩	回蕩	飄搖	飄然	飄舞	飛舞	飄忽	招展	飛揚	嫋嫋	依依	飄動	飄拂	飄落	飄飄揚揚	彩蝶飛舞	翩翩飛舞	揚塵	高揚	飄飄	飄曳
移動	運動	活動	挪動	位移	挪	動	走	倒	移位	舉手投足	挪窩	平移	移步
滑動	滑行	滑	滑跑
等速運動	勻速運動
簡諧運動	諧振
動彈	動作
跳動	撲騰	跳	雙人跳
搖擺	搖晃	搖動	搖盪	搖曳	擺動	晃動	晃蕩	晃悠	悠蕩	晃	悠	忽悠	搖搖晃晃	半瓶子晃蕩	深一腳淺一腳	顫巍巍	顫悠
顫動	抖動	顛簸	顛	震	簸蕩	震盪	振盪	振動	震動	共振
旋轉	打轉	轉動	轉悠	旋	轉	盤	兜	團團轉	筋斗	蟠	跟鬥	旋動	漩起	打轉兒	大回轉
運轉	運行	運作	周轉
盤旋	迴旋	縈回	回繞	打圈子	兜圈子	繞圈子	連軸轉	轉來轉去	轉圈	轉體
繚繞	旋繞	縈繞	縈回	盤曲	回環	回	彎彎
滾動	骨碌	滾	滴溜溜轉	一骨碌	輪轉
掉轉	扭轉	回轉	反過來	扭	回	撥	轉	掉	磨	翻轉	扭動	扭曲	轉過	轉頭
轉身	回身
彎轉	彎	曲	屈
潤澤	滋潤	潤滑	潤
刺激	刺	煙	辣	薰	殺	咬	淹	條件刺激	嗆	剌
撞	擊	拍	碰	磕	打	撞擊	衝擊	衝撞	磕碰	相撞	相碰	碰撞	硬碰硬	撞倒	磕磕碰碰	碰上	碰碰	猛擊	橫衝直撞	驚濤拍岸
觸	碰	沾	點	硌	接觸	沾手	觸及	觸發
著	巴
相遇	遇	撞	逢	相逢	遇到	碰到	遇見	撞見	碰見	相見	打照面	碰面	遇上	趕上	欣逢
狹路相逢	冤家路窄	狹路相遇
巧遇	偶遇	邂逅	不期而遇	萍水相逢	邂逅相逢
重逢	久別重逢	舊雨重逢
錯過	相左	失之交臂	交臂失之	擦肩而過
摩擦	磨蹭	磨	擦	蹭	錯	掠	拂	摩	吹拂	磨光	抗磨
附著	黏附	依附	嘎巴	沾	巴	蹭	沾滿	屈居	附上
暢通	通暢	暢達	通達	無阻	交通	通	通行無阻	四通八達	直通	暢通無阻	風雨無阻	暢行	通行	風裡來雨裡去	暢行無阻
通風	透風	通氣	透氣
阻塞	閉塞	蔽塞	堵塞	梗塞	擁塞	淤塞	不通	梗阻	阻隔	隔閡	淤滯	梗	淤	死	過不去	堵截	卡脖子	綠燈	打斷	短路	閡	死死的	圍堵	封堵	查堵	卡住
卡	鯁	叉	咬	卡殼	軋	噎	障
漏	透	滲透	滲漏
漏水	滲水	滲出
漏風	透風
漏光	透光
漏氣	透氣
交界	分界	接壤	鄰接	毗鄰	毗連
靠近	鄰近	接近	臨近	挨近	貼近	將近	近乎	靠攏	湊攏	攏	湊	守	近	傍	濱	即	瀕	瀕臨	瀕於	臨	臨到	挨著	湊近	身臨其境	駛近	走近
緊靠	緊貼	相依	偎依	偎	比	附	挨	把	倚	就	促	靠
逼近	迫近	逼	薄	壓	臨界	壓境	侵	旦夕存亡
相距	距離	離開	離	去	距	偏離	相差
連綿	綿亙	蔓延	綿延	連連	逶迤	迤邐	此起彼伏	連綿不斷	連續不斷	綿延不斷	持續性	綿綿不絕
相隔	分隔	隔	相間
圍繞	環繞	纏繞	盤繞	環抱	回環	拱抱	拱衛	圍	圈	環	拱	繞	縈	纏
包圍	包	重圍
簇擁	擁	前呼後擁
扭結	糾結	糾	交融
交叉	交	叉	交加	立交
交錯	縱橫	闌幹	犬牙交錯
混雜	攙雜	夾雜	糅雜	糅合	錯落	混合	交織	攪混	攪和	交集	插花	雜	混	夾	糅	泥沙俱下	龍蛇混雜	魚龍混雜	良莠不齊	摻	混同	錯綜	勾兌	摻雜
超重	過重	超載
傳導	傳	導	輸導	傳輸
傳播	傳佈	散播	流傳	傳揚	擴散	傳	不脛而走	不翼而飛	傳出	傳唱	傳到	傳來	傳頌	傳誦	傳入	傳回	傳遍	傳感	廣為流傳	盛傳	長傳	傳開	廣為傳頌
流傳	傳	垂	沿	沿襲	一脈相傳	衣缽相傳
世傳	傳世	世襲	家傳	祖傳	世代相傳	薪盡火傳	傳代	傳種	宗祧	代代相傳
傳說	相傳	風傳	哄傳
謠傳	以訛傳訛	謬種流傳
流行	風行	盛行	風靡	時興	興	盛	大行其道
成風	蔚然成風	蔚成風氣
相沿成習	約定俗成
連接	連	通	接	搭	屬	交接	接合	銜接	連通	通連	連貫	連綴	接通	對接	過渡	緊接	連結	連著	聯接	聯網	接入	相聯	連片	連成一片	成群連片	中繼
承	承接	承上啟下	承先啟後	承載	承前啟後
聯繫	關聯	牽連	關係	維繫	掛鉤	溝通	搭頭	聯絡	具結
組網	連網
糾纏	纏	繞	絞	縈	纏繞	繞組
積壓	積	鬱	鬱結	鬱積
結合	組合	結成	構成	組成	做	成	結	結節	結緣	燒結	粘結	血肉相聯	粘連	咬合	整合	重組	三結合
割裂	隔斷	隔絕	隔離	斷	切斷	凝集	與世隔膜
相持	對峙	對壘	對抗	對立	膠著	分庭抗禮	對陣	僵持	勢不兩立	膠著狀態	對攻
鼎立	三足鼎立
生效	見效	奏效	收效	立竿見影
失效	失靈
陪襯	烘襯	映襯	襯映	襯托	烘托	掩映	相映	鋪墊	烘雲托月	搭配	反襯	配搭	選配	銀箔襯
點綴	裝點
定局	決定	定	已然	成議	穩操勝券	木已成舟	覆水難收	生米煮成熟飯	操勝券	一錘定音	註定	塵埃落定
未定	未決	存亡未卜	沒準兒
已婚	成家
團結	合力	通力	協力	並肩	團結一致	精誠團結	群策群力	打成一片	抱成一團	大團結	合璧	融匯	互聯	同苦共樂	大一統	團結一心	圓融	同甘	同苦	憂患與共	甘苦與共	並肩作戰	一損俱損	紮堆兒	強強聯合	同甘苦
同心	齊心	一條心	齊心合力	同心同德	同心協力	戮力同心	眾志成城	同仇敵愾	敵愾同仇	並力	上下一心	上下齊心
和衷共濟	同舟共濟	同甘共苦	呼吸與共	休戚與共	患難與共	風雨同舟	各司其職	人和	榮辱與共	融合	融為一體	生死與共	萬眾一心	攜手並肩	齊心協力	一心一德	眾人拾柴火焰高
求同克異	求同存異
合併	歸併	歸攏	歸總	統一	集合	匯合	聯合	聯結	聯	合	合而為一
一統天下	世界一統
三位一體	統一體
分裂	瓦解	支解	解體	崩潰	土崩瓦解	分崩離析	四分五裂
分道揚鑣	各行其是	各自為政	各謀其政	各持己見	各奔東西	各奔前程
離心離德	同床異夢	貌合神離	各執一詞
團聚	聚會	聚首	團圓	大團圓	鵲橋相會	歡聚一堂	團圓飯	闔家團圓	圍聚	相聚	共聚	歡聚	歡聚一堂	會聚	分久必合
離別	分別	作別	別離	分離	分開	分手	解手	訣別	分袂	暌違	仳離	別離	合久必分
背井離鄉	離鄉背井	離京	不辭而別
闊別	久別	久違
永別	永訣
集合	聚合	湊合	會合	會師	集聚	彙聚	聚集	叢集	齊集	集結	結集	聚攏	圍攏	湊攏	聚	集	湊	匯	湊集	懷集	聯誼	聚眾	攢動	成團	萃	會集	聚攏	集納
聚齊	取齊	集中	彙集	匯流	匯總
密集	麇集	成群結隊	三五成群	攢三聚五	湊數	湊足	凝	凝聚
糾集	糾合	嘯聚	結社	總匯
雲集	薈萃	集大成	鸞翔鳳集	濟濟一堂	群蟻附膻
分散	疏散	散開	散落	散	分流	散架	粗放	發散	散放
星散	風流雲散	飄散	四散
離散	天各一方
妻離子散	鸞飄鳳泊	勞燕分飛
如鳥獸散	樹倒猢猻散
佔先	領先	打頭	打先鋒	一馬當先	遙遙領先	打前站	打頭陣	最前沿
為首	帶頭	領頭	領銜	捷足先登	牽頭	敢為人先	領袖群倫	為先
爭先	搶先	搶	爭先恐後	先發制人	先聲奪人	奮勇爭先	競相	爭相	先下手為強
殿后	排尾
落	掉
命中	打中	擊中	中	猜中	擊中要害	槍響靶落	切中	歪打正著
進步	上進	向上	提高	發展	前進	長進	百尺竿頭，更進一步	更上一層樓	竿頭日進	進化	騰飛	昇華	邁入	前行	上揚	上移	開拓進取
奮進	躍進	邁進	猛進	高歌猛進	突飛猛進	一往無前	勇往直前	闊步前進	昂首闊步	乘風破浪	長風破浪	破浪前進	拚搏	義無反顧	奮發上進	勢在必進	前進不懈	求進	銳意進取
漸進	循序漸進	穩步前進	由淺入深	穩中求進	穩中有進
並進	齊頭並進
退步	落後	落伍	掉隊	退化	後退	倒退	開倒車	走下坡路	滑坡	江河日下	滯後	向下
墮落	腐化	蛻化	失足	落水	敗壞	窳敗	腐敗	蛻化變質	掉入泥坑	誤入歧途	一誤再誤	不能自拔	玩物喪志	貪污腐化	不思進取	吃喝玩樂
實行	推行	履行	執行	施行	實施	實踐	踐	履	執	盡	行
遵行	奉行	普及	施訓	推廣
舉行	召開	開	做
完成	完竣	完結	完了	完事	落成	交卷	成功	成就	就	好	完	竣	得	蕆	大功告成	瓜熟蒂落	水到渠成	一氣呵成	大功告成	功德圓滿	一揮而就	畢其功於一役	到位	形成	做到	不辱使命	姣好	不負眾望
脫稿	定稿	殺青	汗青
脫手	出手	得了
實現	兌現	貫徹	落實	促成	心想事成	奮鬥以成
耽誤	延誤	耽擱	愆期	違誤	遲誤	誤	誤工
拖延	延宕	耽擱	因循	遷延	捱	拖	宕	蘑菇	拖錨
期滿	滿	滿期	任滿
到期	到時	屆時	屆期	屆	到	臨	到點	截稿
過期	逾期	脫班	晚點	誤點	過	超時
來得及	趕得及	亡羊補牢	趕趟	猶為未晚
來不及	趕不及	不及	不迭	措手不及	為時已晚
禁得起	經得起	禁得住	吃得住	吃得消	受得了
禁不起	禁不住	經不起	不堪	吃不消	吃不住	架不住	受不了
享福	納福	享樂	享清福
吃苦	受苦	受罪	遭罪	吃苦頭	風吹日曬
沾光	討巧	受益	得益
佔便宜	討便宜	撿便宜	貪便宜
不勞而獲	吃現成飯	無功受祿	坐享其成	坐收漁利	漁人得利	吃現成
受益匪淺	獲益匪淺
互惠	互利
上當	受騙	上鉤	冤	蒙在鼓裡	吃一塹
吃虧	吃啞巴虧
走運	幸運	萬幸	天幸	有幸	僥倖	碰巧	託福	走紅運	洪福齊天	三生有幸	好運	鴻運	大吉	大幸
發財	發家	發跡	發家致富
暴富	暴發	發橫財	發大財
吉利	吉慶	吉祥	吉	瑞	祥	祺	紅	萬事大吉	吉星高照	吉人天相	大吉大利	吉祥如意	開門紅
倒楣	倒運	揹運	背時	背	不幸	不祥	薄命	晦氣	喪氣	觸黴頭	命途多舛	命乖運蹇	生不逢時	惡運	困窘	窘困	噩運
多災多難	禍不單行	雪上加霜	避坑落井
走投無路	走頭無路
糟糕	壞	不得了	不好
順利	順手	湊手	順遂	順暢	順當	順	勝利	平順	如願	遂願	得手	平平當當	順順當當	風調雨順	一帆風順	一帆順風	乘風揚帆	無往不利	地利人和	萬事亨通	左右逢源	得心應手	如臂使指	如願以償	盡如人意	天從人願	稱心如意	萬事大吉	必勝	稱心如願	順風	萬事如意	一路順風	苦盡甜來	瑞氣盈門	暢順
順勢	趁勢	順水推舟	借風使船	借水行舟	因勢利導
不利	周折	不遂	坎坷	好事多磨	事與願違	橫生枝節	節外生枝	疙疙瘩瘩	逆水行舟	艱難曲折
尷尬	狼狽	窘迫	受窘	坐困	為難	兩難	窘	僵	騎虎難下	勢成騎虎	左支右絀	左右為難	不上不下	進退兩難	進退維谷	哭笑不得	啼笑皆非
一籌莫展	束手無策	毫無辦法	焦頭爛額	內外交困	山窮水盡
折磨	折騰	揉搓	煎熬	磨難	磨
成名	揚名	馳名	出名	蜚聲	馳譽	著稱	一舉成名	功成名遂	身價百倍	名揚四海	名滿天下	一鳴驚人	一飛沖天	揚威	一炮打響	名聲大振	名聲鵲起	走紅	成名成家	名揚	馳名中外	露臉
聲名鵲起	萬世流芳	萬古留芳
名譽掃地	掃地	身敗名裂	遺臭萬年	臭名遠揚	臭名昭彰
出醜	丟醜	丟臉	丟人	坍台	現世	見笑	現眼	出洋相	鬧笑話	丟面子	丟人現眼	當場出彩	出乖露醜	方家見笑	狼狽不堪	落湯雞	下不來	下不了臺	辱沒門庭	掉價
得志	得意	稱意	騰達	飛黃騰達	春風得意	蛟龍得水	破壁飛去	洋洋得意	少懷壯志
失意	落拓	潦倒	蹭蹬	懷才不遇	窮途潦倒	潦倒終身	喪志	報國無門
失業	賦閑	砸飯碗	丟飯碗	待業	下崗	無業	待崗
丟官	免職	罷官
晉升	提升	升級	晉級	升格	升遷	升官	升任	榮升	遞升	調升	飛升	調幹	升級換代
扶搖直上	步步高升	官運亨通	一步登天	平步青雲	直上雲霄	雞犬升天	夫貴妻榮	平步登天	青雲直上	提級	升官進爵
降級	降職	貶職	左遷	降	貶	謫	降格	貶低
升貶	升降	浮沉	沉浮	與世沉浮	升升降降
入選	中選	當選	膺選	選中	相中	選為
考中	考取	中式	及第	折桂	取	蟾宮折桂	金榜題名	榜上有名
落第	名落孫山	落榜	落聘	落選
受累	黑鍋
受冤	蒙冤	冤枉	冤屈	銜冤	含冤	飲恨	莫須有	含冤	冤沉海底	抱恨終天	奇冤
背黑鍋	李代桃僵
平反	昭雪	雪冤	洗冤	申冤	洗雪	洗刷
受獎	獲獎	得獎
受罰	抵罪	受過
被捕	落網	束手就擒
入獄	下獄	坐牢	在押	服刑	吃官司	陷身囹圄	身陷囹圄	鋃鐺入獄
得寵	受寵	得勢
失寵	打入冷宮	坐冷板凳
撲空	吃閉門羹
碰壁	碰釘子	打回票	一鼻子灰
自作自受	自食其果	自掘墳墓	自投羅網	自取滅亡	飛蛾投火	咎由自取	玩火自焚	惹火燒身	作繭自縛	作法自斃	揠	自找
自討苦吃	自找麻煩	自討沒趣	自尋煩惱
適得其反	事與願違	幫倒忙	抱薪救火	揠苗助長	以火救火	弄巧成拙	畫蛇添足	南轅北轍	過猶不及	弄假成真
斷子絕孫	斷後	無後	絕後
守寡	寡居	孀居
受災	遭災
鬧災荒	鬧饑荒
旱	大旱	久旱	亢旱	旱魃為虐	赤地千里	水旱	崩岸	旱極	受旱
澇	洪澇
發水	山洪暴發	氾濫成災	水漫金山	一片汪洋	雨澇
開口子	決口
受害	被害	遇害	遭難	蒙難	死難	遇難	罹難	落難	遇險
遭殃	禍從天降	深受其害
中彈	飲彈
遇刺	遇害
失火	起火	發火	失慎	走火
走電	跑電	漏電	電擊
觸電	電
失竊	失盜
迷路	迷途	迷航	迷失
失蹤	走失	下落不明	不知去向	渺無聲息
不見蹤影	無影無蹤	音信全無	杳無音信	杳如黃鶴	銷聲匿跡	杳無音訊
遺失	丟失	丟掉	不見	散失	丟	少	掉	不翼而飛	遺落	有失
闖禍	肇禍	惹禍	出事	出亂子	出岔子	惹是生非	釀禍
召禍	招災惹禍	捅婁子
遇救	獲救	得救
脫險	出險	死裡逃生	虎口餘生	劫後餘生	九死一生	兩世為人	避險	倖免於難
勝利	取勝	戰勝	獲勝	得勝	制勝	告捷	大捷	奏捷	奏凱	凱旋	勝	贏	捷	凱	出奇制勝	克敵制勝	旗開得勝	屢戰屢勝	哀兵必勝	百戰百勝	百戰不殆	力克	常勝	大勝	力挫	節節勝利	大獲全勝	前車之覆
戰敗	失敗	打敗	敗陣	敗北	敗績	失利	潰敗	潰退	敗	負	輸	北	不戰自敗	負於	必敗	敗退	輸給	落敗	吃敗仗	滿盤皆輸	國破家亡	敗走麥城
慘敗	大敗	一敗如水	一敗塗地	損兵折將	棄甲曳兵	丟盔棄甲	人仰馬翻	頭破血流	潰不成軍	轍亂旗靡	望風披靡	落花流水	潰	馬仰人翻	全軍覆沒
覆沒	覆滅	片甲不存
被圍	腹背受敵	插翅難飛	四面楚歌
淪陷	陷落	失陷	失守
亡國	滅亡	淪亡	亡	滅
勝敗	高下	勝負	輸贏	成敗
成功	成事	有成	打響	成	遂	得逞	得計	馬到成功	水到渠成	功成名就	因人成事	中標	卓有成就	不負眾望	事業有成	學有所成	一人得道
失敗	挫敗	破產	砸鍋	受挫	挫折	跌跤	敗	黃	垮	躓	砸	栽跟頭	功虧一簣	功敗垂成	敗訴	寡不敵眾	栽斤頭	夭	成不了	敗退	惜敗	難倒	告負	未果	沒戲	吃敗仗
垮臺	坍台	塌台	倒臺	完蛋	塌架	崩潰	潰滅	夭折	倒	玩兒完	嗚呼哀哉	傾家蕩產	旁落
倒閉	關閉	停閉	停歇	關門	關張	關	關門大吉	閉館
停業	歇業	毀於一旦
打垮	搞垮
落空	泡湯	流產	吹	漂	一場空	一場春夢	南柯一夢	付之東流	雞飛蛋打	前功盡棄	未遂
敗露	東窗事發	圖窮匕見
暴露	露	表露	露餡兒	露馬腳	暴露無遺	不打自招	紙包不住火	此地無銀三百兩	直露	展露	爆出
顯形	現形	原形畢露
大白	真相大白	水落石出
洩漏	透漏	走漏	洩露	走風	漏風	走漏風聲	外泄
洩底	露底	兜底
失密	洩密	失機
賺	得利	盈利	盈餘	獲利	創匯	創利	夠本	扭虧為盈	掙	掙錢	致富	賺錢	賺取	淨賺	扭虧
虧	蝕	賠	折	賠本	蝕本	折本	虧本	虧蝕	賠帳	吃老本	賠錢	賠帳	啞巴虧
損失	破財	海損	折價
虧空	虧欠	虧累	空	拖欠	缺損
合算	上算	划算	經濟	劃得來	佔便宜	事半功倍	一石多鳥
一舉兩得	一箭雙雕	多快好省
失算	划不來	得不償失	事倍功半	小題大做	勞民傷財	因小失大	貪小失大	因噎廢食	進寸退尺	捨近求遠	偷雞不著蝕把米	舉輕若重
涸澤而漁	竭澤而漁	殺雞取卵
失策	失計
失機	失時	坐失良機	失之交臂
豐收	豐產	豐登	大有	五穀豐登	多產	保收	碩果累累	購銷兩旺	倉滿庫盈
歉收	欠產	歉
開始	肇始	開端	肇端	造端	發端	開頭	起頭	起來	起	始	開	啟	下車伊始	初步	上馬	始於	從頭	方始	始起	啟幕	初始	初露	開班	始發	千帆競發
入手	著手	動手	下手
開工	興工	動工	上工
破土	破土動工
開學	始業
開市	開拔	開飯	開篇	開賽	開業
開動	開行	起步	起動	起先	啟動	啟航
啟程	起程	登程	上路	動身	起身	起行	出發	首途
開車	發車
開航	起航	出航	啟碇	起碇	起錨	拔錨	揚帆
起飛	起航
起運	啟運	起
開幕	揭幕
開演	開場	開台
萌發	萌芽	萌動	萌生	萌
起跑	開戰	開講	開課	開犁	開鋤	開鐮	開張	開盤	開拍
入春	入夏	入秋	入冬
結束	收束	終止	收場	完結	收攤兒	了結	了卻	終了	告終	了局	了事	完畢	完竣	告竣	竣工	停當	煞尾	收尾	掃尾	俐落	終結	為止	截止	畢	罷	訖	完	結	收	煞	了	央	闋	一了百了	壽終正寢	查訖	得了	善終	了斷	說盡	草草收場	殆盡
甘休	罷手	住手	歇手	甘休	善罷甘休	用盡
作罷	罷了
散會	閉會	休會	閉幕
散場	散	終場	劇終	落幕
畢業	卒業	結業
下班	下工	放工	收工
收操	下操
下學	放學
售完	售罄	脫銷	銷售一空
停止	終止	休止	止息	停息	停歇	打住	止住	煞住	下馬	平息	停	止	艾	寢	息	住	輟	歇	休	已	罷	適可而止	偃旗息鼓	鳴金收兵	停下	懸停	人亡政	停停	告一段落
停滯	僵化	停滯不前	撂挑子	駐足
打烊	關門
熄滅	熄	煞車
停戰	停火	化干戈為玉帛
住口	絕口	住嘴
中斷	中止	中輟	停頓	頓	間斷	拋錨	刹車	擱淺	半途而廢	戛然而止	間歇	暫停
望而止步	駐足不前
進行	進展	開展	展開	拓展	拓
雙管齊下	齊頭並進	並舉
繼續	連續	延續	接續	蟬聯	繼承	累	承	繼往開來	前赴後繼	前仆後繼	此起彼伏	踵事增華	持續	後續	接軌	維繼	存續	餘波未停	此起彼落
流逝	蹉跎	荏苒	光陰荏苒	無以為繼
寒來暑往	年復一年	春去秋來	物換星移
重複	反復	重	複	再	一再	再三	故伎重演	故態復萌	老生常談	老調重彈	三翻四複	翻來覆去	顛來倒去	疊床架屋	重申	反反復複	故技重演	重蹈覆轍	重蹈	陳年老辭	重溫	再行
迴圈	輪回	循環往復	周而復始	大循環	巡迴
微循環	小迴圈
變化	變	轉變	變動	更動	浮動	變通	變更	變卦	變遷	扭轉	轉移	轉	彎	別	生成	變化無常	變型	思新求變	應時而變	走形	成形
變幻	無常	變幻莫測	變幻無常	變化不定	千變萬化	瞬息萬變	夜長夢多	雲譎波詭	波譎雲詭	白雲蒼狗	風雲變幻
多變	反復無常	朝三暮四	朝秦暮楚	朝令夕改	變化多端	搖身一變	變異	形成	演進	善變
演變	演化	衍變	嬗變
情隨事遷	事過境遷	滄海桑田	移花接木
劇變	突變	急變	驟變	急轉直下	面目全非	愈演愈烈
漸變	潛移默化	默化潛移
質變	變質	蛻變
變臉	變色	翻臉	一反常態
變味	黴變
變樣	走樣
成為	變成	成	變為	化為	化	改成	改為	化作
歐化	西化
改變	變更	更動	變動	改動	轉移	改	移	轉	反	改成	改觀	更改	切變
改換	更換	變換	轉換	換	易	變	撤換	代換	移	轉移	演替	易位
輪換	替換	掉換	倒換	交替	更迭	調換
交換	鳥槍換炮	置換	包換	包退	換換	換成
改天換地	移風易俗	旋轉乾坤	更新換代	星移鬥換
改弦更張	改弦易轍
改元	改朝換代
改行	跳行
改名	化名	改名換姓	更名	改性	易名
改口	改嘴
轉調	變調	移調
轉車	換車	倒車	中轉	轉發	轉化	轉會	轉接	轉速	轉向	轉用	轉帳	轉折	轉正
擴大	壯大	擴充	擴展	擴張	恢弘	恢宏	推而廣之
放大	放	放開	加大	擴	推廣	拓寬	日見其大
膨脹	膨大	脹	漲	體膨脹	線膨脹	猛漲	暴漲	暴脹	微漲
蔓延	滋蔓	迷漫
伸長	伸
延長	延伸	延	拉開	延綿
延年益壽	益壽
收縮	抽縮	抽	縮	縮合
縮小	壓縮	緊縮	簡縮
縮水	抽水	冷縮	濃縮	縮編	縮短
浸濕	濕	沾	濡染	漬	浸潤	浸透	濕邪	濡
增多	增加	加碼	充實	增	長	多	加	添	益	搭	追加	平添	淨增	加進	由小到大	日增	大增	有增無減
增長	豐富	助長	長	加上	累加	日益增長	抬高	添加
外加	附加	疊加	增大
遞增	遞加	與日俱增
激增	猛增	劇增	新增	有增無已	與年俱增	增產	驟增	陡增	增創	瘋長
倍增	加倍	倍	倍加	成倍	乘以	雙增長
增值	升值
添油加醋	添枝加葉
添補	增補	找補	抵補	補	填補	補充	補給	補缺	補償	填空	找齊	上	續	添	加	互補	彌
補遺	拾遺	拾遺補闕	填平補齊
彌補	彌縫
減少	減去	縮減	減縮	壓縮	削減	裁減	節減	核減	減	刨	抽	裒	消損	打折扣	滑坡	回落	減掉	減下	減小	釋減	輕裝簡從	精減	調減
裁	淘汰
減半	折半	扣除
減員	裁員
裁軍	精兵簡政
驟減	劇減
優勝劣汰	選優淘劣
上升	升高	升	升起	升騰	蒸騰	騰達	騰	起	狂升	穩中有升
騰空	淩空	爬升	攀升	抬高	騰飛	飆升
提高	增高	拔高	昇華
漲	上漲	高漲	水漲船高	飛漲	高升
漲潮	來潮	漲風	漲價	提速
躍升	躍居
下降	降落	下落	跌落	落	降	退	跌	降低	減低	減退	減色	低落	暴跌	回落	下跌	下滑	驟降	下挫	狂跌	滑降	銷價	大跌	穩中有降
落潮	退潮	猛跌
降價	減價	跌價	削價	掉價兒	落價	廉價
貶值	毛	通貨膨脹
升降	起落	起伏	沉降	大起大落	起降	漲落	潮漲潮落	漲跌
提前	提早	超前
推遲	延遲	推延	推	延	緩	延期	緩期	延緩	展緩	順延	推移	滯緩
加快	加速	加緊	開快車	兼程	快馬加鞭	增速
放慢	減速	減慢	緩一緩	緩手	緩減
鞏固	固	加固
安定	安	壓	定
增強	加強	提高	增高	增進	增長	滋長	如虎添翼	三改一加強
加劇	加深	加重	激化	強化	變本加厲	火上加油	火上澆油	加油添醋	深化
強國	興國
削弱	減弱	衰弱	弱化	減殺	減	鑠
沖淡	和緩	緩和	軟化	降溫
抓緊	趕緊
放鬆	鬆勁	松	放寬	松扣
好轉	改善	改進	有起色	上軌道	漸入佳境	日臻完善
出頭	轉運	時來運轉	轉禍為福	因禍得福	否極泰來	苦盡甘來	重見天日	開雲見日	起色
轉危為安	化險為夷	逢凶化吉	絕處逢生	死裡逃生	九死一生	文藝復興	有色
再生	更生	復蘇	復興	枯木逢春	複業	複館	勃發生機
改進	改善	改良	精益求精	刮垢磨光	更上一層樓
惡化	逆轉	毒化	惡變
傾覆	大廈將傾	樂極生悲
更新	翻新	創新	換代	履新
面目一新	煥然一新	萬象更新
破舊立新	除舊佈新	推陳出新	革故鼎新	吐故納新	花樣翻新	除舊迎新	舊貌換新顏
整舊如新	更型換代	基礎代謝	刷新	以舊翻新
復舊	復古
故態復萌	舊病復發	故伎重演	老調重彈
新生	新興	初生	後起	後來	旭日東昇	噴薄欲出
興起	起來	突起	奮起	勃興	群起	蜂起	起	風起雲湧	四起	應運而起
衰落	沒落	敗落	破落	中落	凋敝	凋零	陵替	衰退	衰老	衰朽	退坡	萎縮	闌珊	衰	萎	強弩之末	日薄西山	大勢已去	一落千丈	落花流水	再衰三竭	萎靡
衰敗	頹敗	破敗	衰微	式微	衰頹
世風日下	人心不古
是	為	乃	系	則	屬
就是	即	便是	就是說	乃是	身為	視為	說是	算得	特別是	實屬
當做	當作	作為	看成	看作	看做	當	作	用作	視作	同日而語
算	算作	不失為	當成	奉為	真是	正是
比作	比方	好比	比喻	譬喻	打比方	況	擬人
叫做	叫作	叫	名	謂	稱	曰	稱為	稱作	號稱	稱呼	稱之為	譽為	諡	斥之為	喻為	名叫	名為	稱做	何謂
自稱	自封	自命
意味	表示	象徵	代表	意味著
影射	隱射	含沙射影	指東說西	借古諷今	指桑駡槐	指雞駡狗
體現	反映	映現
標誌	標明	表明
顯示	顯得	來得	展示	示	顯	著	亮	形	出示	呈示	剖示	兆示
顯見	足見	可見	凸現	看得出
預示	預兆	預告	主	兆
證明	證實	證驗	驗證	印證	說明	應驗	證	征	辨證	求證	認證	作證	驗明正身
起源	來源	發源	導源	根源	來	自	源	來源於	來自	門源	緣于	源於	出自
取決	在於	在乎	有賴於	在	取決於	有賴
歸於	歸屬	著落	屬	落	歸	責有攸歸	直轄	百川歸海	歸入	名下
屬於	屬
隸屬	直屬	附屬	附設	從屬	依附	配屬	專屬
所屬	分屬
相同	同	雷同	同樣	同一	一樣	一律	一色	一致	劃一	等同	同等	平等	翕然	一	平	一模一樣	一如既往	千篇一律	天下烏鴉一般黑	毫無二致	如出一轍	無異	無異于	均等	等同於	一碼事	等效	亦然	扯平	同義	扳平	等位
不約而同	殊途同歸	異曲同工	同工異曲	不謀而合	如出一轍
眾口一詞	異口同聲	眾口一聲
同年	同歲	同庚	同齡
同班	同窗
相等	相當	對等	等於	頂	當	抵	等	齊	侔	埒	半斤八兩	等價	齊名	相當於
匹敵	敵	頡頏	抗衡	媲美	比美	伯仲之間	旗鼓相當	勢均力敵	工力悉敵	不相上下	並駕齊驅	棋逢對手	分庭抗禮	相持不下	銖兩悉稱	平起平坐	平分秋色	拉平	平產	打平
等距離	等距
差不多	差不離	大同小異	五十步笑百步	各有千秋	戰平	幾近	差之毫釐	相差無幾
不同	各別	兩樣	不一	不比	不等	殊	異	差	二	歧	人心如面	莫衷一是	言人人殊	見仁見智	龍生九子	今非昔比	不可同日而語	敵眾我寡	各異	例外
迥	懸殊	上下床	截然不同	迥然不同	判若雲泥	眾寡懸殊	天差地遠	寸木岑樓	大相徑庭	面目皆非	物是人非	有所不同	迥然	迥異	迥然相異	殊異於世
相反	相左	悖	南轅北轍	戴盆望天	反之	恰恰相反	有悖於	反過來說	相悖	有悖
相似	相像	形似	貌似	似的	一般	般	誠如	維妙維肖	類同
近似	相近	切近	近乎	接近	仿佛	相仿	類似	類乎	類	八九不離十	好像	恍如	恍若	看似	像樣	像是
好似	似乎	如同	有如	不啻	宛然	宛如	猶如	像	宛	似	若	如	猶	宛若
活像	酷似	神似	恰似	恰如	儼然	儼如	肖
例如	比如	譬如	諸如	如	像	比如說	譬如說
如下	如次	一般來說	正如	正象	之類
超過	超出	超越	壓倒	不止	淩駕	蓋	浮	超	過	逾	有過之無不及	大於	高於	過量	超乎	出乎	勝出
勝於	勝似	強似	勝	賽	強	愈	高	大	略勝一籌	後來居上	過人	青出於藍	稍勝一籌	勝過
不及	不如	不比	沒有	比不上	遜色	亞	低	小	低位	亞於	自愧弗如
相形見絀	相形失色	小巫見大巫	望塵比步	略遜一籌
不可企及	望塵莫及	低於	僅次於	小於	遜	自愧不如
適應	服	適於	恰切
相配	般配	匹配	配合	相稱	相當	匹	門當戶對	郎才女貌	相容
相輔相成	相輔而行	相得益彰	對稱	珠聯璧合
符合	吻合	適合	切合	契合	合乎	相符	符	副	合	切	入	抱	可	稱	嚴絲合縫	順應	核符
相投	對	對頭	對勁	合得來	說得來	投契	投機	投緣	合轍	合拍	入港	莫逆	一見如故	情投意合	心心相印	志同道合	意氣相投	氣味相投	對勁兒	投合
臭味相投	沆瀣一氣	一鼻孔出氣	對味	合群	酒逢知己
巧合	偶合	戲劇性
不合	不符	方枘圓鑿	圓鑿方枘	文不對題	答非所問	前言不搭後語	牛頭不對馬嘴	驢唇不對馬嘴	走調兒
名不副實	言過其實	名過其實
合不來	說不來	話不投機半句多	話不投機
相對	對立	針鋒相對
矛盾	抵觸	齟齬	擰	格格不入
自相矛盾	水火難容
需要	需	要	消	欲	用	得	待	索要	亟需	急需	亟待	內需	特需
提供	供	資
供給	供
供應	支應	供
滿足	飽
供求	供需
連貫	貫通	貫注	貫穿	貫串	貫	縱貫	由上至下
呼應	相應	照應	應和	前呼後應	首尾相應	對應	附和	隨聲附和	遙相呼應	對號入座
易於	容易	易	善	好	愛	輕	便於
存在	在	有	是	存	留存	設有
碩果僅存	魯殿靈光	社會存在
共存	共處	依存	並存	長存	存活	古已有之	水土保持	萬古長存	現有	倖存	永世長存	存世
遺留	留	剩	遺	貽	留置	殘留	殘存	餘蓄
留	蓄	養	留成	留給	留下	留住	雁過拔毛	預留
保持	維持	護持	維繫	保全	保	葆	涵養	保障
撐持	支持	支撐	繃	永葆	引而不發
處於	居於	處	處在	地處	遠在	介乎	高居	占居
位於	坐落	在	居	廁	廁身	置身	放在	位居	雄居	座落	處身	身處
沉浸	沐浴	正酣
在於	在乎	在	介於
陷於	陷入	陷落	淪	淪落	沉淪	困處	淪為	深陷
適逢	適值	遭逢	正逢	恰逢	正當	時值	正值
登載	刊載	刊登	見報	發表	上	刊	載	登	刊出	報載	披載	登出	摘登
有	擁有	保有	領有	所有	具有	賦有	享有	富有	負有	具備	享	具	備	兼而有之	持有	獨具	懷有	兼備	有了	有所	有著	裝有	秉賦	實有	頗具	賦有	存有	抱有	兼有	兼具	不無
集體所有	共有
還有	再有
佔有	佔據	占	霸佔	擠佔	佔用	奪占	據為己有
容納	包容	容	盛	相容並包	兼收並蓄	無所不容
包括	囊括	包羅	牢籠	席捲	總括	概括	賅	包	連	不外乎	統攬	攬括
充滿	充塞	充溢	填滿	洋溢	飄溢	充斥	浸透	載	滿	盈	滿盈	括	滿載
滿懷	包藏	懷	蓄	存	銜	抱	懷著	滿腔
包含	含	噙	包孕	帶有	含有	含蓄	蘊涵	蘊蓄	韞	寓	蘊	蘊藏	蘊含	蘊藉	飽含	分包	隱含	富含	涵	盈盈	包蘊	暗含	深蘊	涵蓋
顯露	表露	流露	顯	露	現	發	透	漾	泛	浮	浮泛	浮現	敞露	發洩	發自	露出	顯出	外露	突顯
呈現	顯現	表現	展現	見	變現	紛呈
出現	現出	長出	冒出	湧出	起	輩出	併發	產出	迭出	面世	應運而生	油然而生	出新
閃現	曇花一現
再現	重現	復發	複出
層出不窮	層見疊出
冒尖兒	脫穎而出	兀現	噴薄而出	脫穎出
兀現	畢現
發生	產生	發出	生出	生	起	鬧	有	來	出	發	時有發生
散發	發	散	泛
突發	爆發	橫生	突如其來	從天而降	平地一聲雷
萌生	萌芽	萌發	萌
發作	犯	作	發
消失	消散	消滅	消亡	消逝	消釋	消解	消退	冰釋	沒有	熄滅	破滅	毀滅	隕滅	澌滅	泯滅	泯沒	磨滅	泯	磨	消	逝	幻滅	收斂	煙消雲散	雲消霧散	渙然冰釋	瓦解冰消	冰消瓦解	一去不復返	泥牛入海	無影無蹤	蕩然無存	石沉大海	化為烏有	風流雲散	煙雲過眼	過眼雲煙	付之一炬	付之東流	灰飛煙滅	付諸東流	流失	一去不返	沖消	淡去	不復存在	遠逝	煙退雲斂
告罄	罄盡	絕跡	滅絕	銷毀	絕滅
失去	失掉	失卻	失	去	奪	錯過	錯開
喪失	喪	淪喪	錯失	痛失
散失	逸	佚
滅種	絕種
失傳	絕版
恢復	還原	復原	回復	平復	光復	複	回升	過來	死灰復燃	借屍還魂	東山再起	捲土重來	重起爐灶	重操舊業	回心轉意	破鏡重圓	和好如初	復壯
緩	緩氣	復蘇	蘇	休養	休息	休養生息
摧毀	毀滅	損毀
解決	速決	迎刃而解	解鈴繫鈴	釜底抽薪	化解	緩解	排憂解難	速戰速決
克服	戰勝	排除萬難	擺平
消滅	撲滅	掃滅	滅	除	鋤	鋤強扶弱	除惡	摧
蕩滌	滌蕩	掃蕩	橫掃
滅絕	根絕	杜絕	除根	根除	肅清	廓清	連鍋端	斬草除根	斬盡殺絕	一掃而空	除惡務盡	殺滅	一掃而光	剪草除根
滅鼠	滅菌
消除	打消	化除	破除	掃除	驅除	免除	剷除	剪除	清除	解除	防除	割除	革除	摒除	擯除	拔除	祛除	排除	屏除	攘除	消弭	去掉	免去	排遣	消	弭	免	破	祛	排	解	敗	脫	紓	辟	散	摒	禳	除掉	勾除	洗消	免掉	撥冗
洗雪	昭雪	雪	洗	洗刷	歸除	剿除
戒除	戒	斷	改掉	力戒
拋棄	擯棄	捐棄	丟棄	廢棄	撇棄	屏棄	毀棄	遺棄	廢除	丟掉	撇開	扔	拋	撇	廢	棄	委	丟	撇下	忍痛割愛	閒棄	摒棄	拋開	剝棄	擯	遏	揮之即去
捨棄	放棄	割捨	割愛	舍	揚棄	舍本求末	舍去
葬送	斷送
埋沒	湮沒	湮滅
牽連	牽累	連累	拖累	帶累	累及	牽涉	牽扯	攀扯	拉扯	拉	關	愛屋及烏	關連
株連	捲入	連鎖反應
涉及	關涉	關聯	關係	關乎	波及	旁及	涉	幹	涉嫌	提到	事關	兼及	論及
相關	相干	有關	連帶	連鎖	系	休戚相關	息息相關	骨肉相連	呼吸相通	血脈相通	唇齒相依	輔車相依	痛癢相關	詿	不無關係
無關	無干	不相干	了不相涉	漠不相關	不關痛癢	井水不犯河水	風馬牛不相及	毫不相干
影響	薰陶	潛移默化	默化潛移	震懾
觸動	感動	打動	撥動	震動	激動	震撼	撼動	撼	動
動搖	搖撼	敲山震虎
動人心魄	蕩人心魄	撼人心魄	蕩魂攝魄
帶動	牽動	帶	帶來	拉動
沾染	浸染	染	習染	濡染	感染	薰染	耳濡目染	染上
傳染	傳	招	染	污染
引起	喚起	挑起	引	逗	招	勾	惹	挑起	招惹	滋生
吸引	招引	抓住	誘惑	誘	掀起	引發	挑動
導致	招致	以致	引致	誘致	致使	招	致	促成	造成
使得	使	令	讓	叫	教	俾	驅動
促使	驅使	敦促
催生	催產
給予	授予	賦予	付與	予以	給以	給	與	予	致	施	賦	加之	寓於	給與
寄予	寄託	寄	依託	委以
加以	加	給定
施加	強加	橫加	栽	致以
冠以	冠
推動	推進	促進	助長	推	有助於	推波助瀾	推濤作浪	後浪推前浪	遞進	推向	力促
激發	激起	激勵	激揚	刺激	振奮	鼓舞	激
提神	興奮	揠苗助長	鼓勁	條件刺激
妨礙	礙	妨	傷	有礙於	有礙
杜絕	杜	堵塞
限制	限量	限定	範圍	限	拘	克	畫地為牢	界定
局限	囿	受制	囿於
約束	約	格	繩	束	斂	律	框	拘束	束縛	系縛	羈絆	牢籠	封鎖	自律	羈
鉗制	牽制	制約	牽掣	掣肘	鉗	制	制裁
制止	抑止	抑制	壓制	遏制	扼殺	壓	挫	殺	平抑	限於
支配	決定	主宰	駕禦	控制	宰製	操縱	操	說了算
超越	逾越	跨越	超過	越	跨	超	跳	躐	逾	過	超常
有利	利於	有益	惠及	造福	福利	便利	方便	便宜	利	好	便民	便於	開券有益	一本萬利	有利於	有益於
富民	利國利民	利民	利國
有害	損害	傷害	危害	禍害	妨害	殘害	戕害	戕賊	貽誤	損傷	挫傷	摧殘	侵蝕	侵害	害	禍	誤	危	損	傷	貶損	害人	加害	迫害	誤傷	重傷
不利	不利於	有損	有損於
無損	無害
防止	防備	防範	防護	預防	提防	嚴防	警備	戒備	防	備	戒	防微杜漸	防患未然	謹防	曲突徙薪	以防	以防萬一
避免	倖免	避	免
逃避	規避	躲避	回避	逃脫	躲開	逃	避開	躲過	避讓	逭
避諱	忌諱	切忌	忌	諱	顧忌	忌口
免得	省得	以免	免於	免受
取得	得到	獲得	博得	贏得	獲取	博取	收穫	到手	得	取	獲	抱	博	落	沾	拿走
垂手而得	近水樓臺先得月	查獲	垂手可得	得出	汲取
失而復得	合浦還珠	得來	應得
榮獲	榮膺	捧得	喜獲	榮立
爭取	爭得	力爭	分得
奪取	奪得	奪
牟取	謀取	牟	漁	拿到
達到	達成	達	臻	上	齊	及	落到	落得	達標	高達	直達
遂	稱	如
挽回	扳回	扭轉	力挽狂瀾
遭受	蒙受	受到	遭遇	遭逢	受	遭	吃	被	罹	挨	負	中	著	蒙	遇	丁	飽嘗	飽受	倍受	備受	慘遭	屢遭	面臨	未遭	遭到	遭劫
享受	消受	享用	享	大飽眼福	大快朵頤	分享	身受	饗
接受	領受	收受	承受	經受	受	領	稟	奉	膺	納
秉承	稟承	受命	採納
忍受	禁受	經受	消受	受	禁	經	熬	熬煎	經得住
非常	異常	特別	格外	分外	十分	十二分	萬分	不勝	百般	百倍	充分	老大	好生	好不	那個	要命	不行	可憐	了不得	不得了	夠勁兒	夠嗆	很	甚	頗	挺	好	老	生	深	良	殊	煞	大	雅	綦	稀	繃	酷	怪	蠻	殺	死	慌	壞	不可開交	死去活來	甚為	煞是	深深的
遠	多	大為	極為	頗為
多麼	多	何等	何其	萬般	多多
最	頂	極	盡	絕	太	透頂	絕頂	極其	極端	極度	卓絕	不過	無上	無比	無限	無以復加	無與倫比	莫此為甚	最好	最為	至極	最最	極致	亢
至多	最多	大不了	充其量	不外	頂多
至少	最少	起碼	足足
過分	過度	過頭	過火	過於	忒	超負荷	矯枉過正
儘量	放量	充分	儘管	盡
殫思竭慮	殫思極慮
更加	更其	越加	越發	一發	尤其	愈加	越來越	愈來愈	進一步	更	逾	愈	越	益	更進一步	更是	更為	益發	尤為	愈發	愈益	越是	進而
相當	一定	一對一
比較	較比	較為	較
稍微	稍為	稍許	稍稍	約略	略略	微微	略微	些微	些許	有點	有些	多少	稍	略	微	粗	小	聊	不怎麼	略帶	略為	稍事	稍加	多多少少
大多	多	大半	大都	大抵	基本上	差不多	幾近
完全	全然	截然	全盤	通通	統統	精光	一齊	全	淨	畢	了	悉	意	一古腦兒	渾然	一點一滴	一心
全數	如數	悉數
精光	淨盡	光	淨	絕	殺光
純粹	純	徹頭徹尾	片甲不留	片瓦無存	淳	上無片瓦
徹底	到底	到頭	翻然	乾淨	根本	壓根兒	窮	根	清	徹	到頂	一乾二淨	完完全全	絕望
半半拉拉	一半	半	大體上
都	淨	全	統	均	備	皆	俱	鹹	胥	僉	全都	通通	通統	統統	一總	清一色
一概	一律	概	概莫能外	個個	毫無例外	無不
只	單	獨	光	止	就	僅	但	才	徒	特	惟	單單	僅僅	不過	偏偏	惟獨	單獨	獨自	唯有	只有	只是	無非	單純	一味	惟有
只不過	左不過	光是	僅只
不止	不僅	不光	不只	不單	不啻	不僅僅
甚至	乃至	甚而	甚或
立刻	即刻	立時	即時	立地	馬上	立即	隨即	當即	迅即	當下	登時	頓時	頓然	及時	眼看	當時	應時	應聲	旋踵	旋即	立	就	即	這	二話沒說	立馬
趕快	趕早	趕緊	趕忙	急忙	連忙	從速	儘早	及早	儘先	爭先	儘快	快	搶	趕早不趕晚	不久	趁早	急匆匆	從快	迅雷不及掩耳之勢	奮勇爭先
逐漸	逐步	漸漸	慢慢	日漸	日趨	逐日	逐月	逐年	漸次	漸	浸	日益	逐級	緩緩地
姑且	暫且	權且	權時	聊	且	權	姑	待會兒	姑妄聽之
臨時	旋	現	即
預先	預	先	先期	先行	事先	優先
首先	率先	第一	先是
準時	正點	限期	如期	按期	按時
經常	時常	常常	素常	時時	每每	不時	時不時	時	常	常川	常事	隔三差五	頻仍	三天兩頭
一再	再三	多次	屢次	累次	屢屢	累累	比比	頻繁	反復	屢	累	迭	頻	數	亟	勤	屢次三番	三番五次	翻來覆去	往往	再而三	高頻	幾度
向來	素來	歷來	自來	從來	根本	一向	平素	平生	素	向	從	固	有史以來	從古至今	從古到今	歷久	常有	素有
本來	原來	原本	原先	原	本	本原	元元本本
不斷	不止	不停	不住	不休	不了	不迭	不已	不輟	無間	穿梭	源源	頻頻	連連	連	綿綿	縷縷	無休止	絡繹不絕	沒完沒了	無盡無休	不絕於耳	不息	持續	日日	時時刻刻	隨地	相接	相連	連發	迴圈不斷	延綿不斷	無窮的	迭起	高潮迭起	娓娓
一口氣	一股勁兒	一鼓作氣	一氣	一舉
一連	接連	連接	連連	連續	連	連天	連日	連年	累年	連珠	接二連三	接連不斷	連續不斷	一個勁	總是	連日來	老是
源源不斷	源源不絕
一直	一味	直	老	總	盡	輒	迄	鎮	始終
時刻	時時	隨時	天天	無日	無時無刻	每時每刻	整日	時時處處	事事處處
每次	歷次	次次	老是
動輒	動不動	動
已經	曾經	業經	業已	早已	早就	久已	已	曾	就	既	都	一度	現已
方才	剛才	适才	才	剛	剛剛	頃	方	甫
新	初	乍	將才
正在	正	在	方	著	正值
隨即	隨後	接著	跟著	跟腳	跟手	繼而	繼	就	繼之	緊接著	進而	隨著	隨之
即將	行將	快要	就要	將	且	將要
終於	終究	終久	終歸	到底	畢竟	總算	算是	算	終	卒	竟	好不容易	到頭來	歸根到底	好容易
再	又	重	更	還	複	再度	再次	重新	從新	重複	雙重	再行	再也	另行
不再	不復
必然	決然	自然	勢必	必將	必定	肯定	一定	准定	定	必	得	一準	定準	遲早	早晚	決計	毫無疑問	大勢所趨	勢將	終將
意料之中	不出所料	定然	決非偶然	自然而然
不可逆轉	不可避免
十有八九	十之八九
管保	保管	管教	包管	保險	保證	准保	確保	擔保	保	包	管	打包票	作保	保准	承保	力保
未必	不一定	未見得	不見得	不致於	不至於
難保	難說	保不定	沒准
突然	忽然	突兀	猛然	驟然	驀然	陡然	遽然	霍然	赫然	猝然	驀地	霍地	忽地	猛地	忽	突	陡	驟	猝	冷不丁	抽冷子	冷不防	猛不防	突如其來	平地一聲雷	出敵不意	出人意料	出人意外	黑馬	幡然	倏然	猛然間	豁然	恍然	爆冷	閃電式
偶然	偶爾	偶發	偶	間或	有時	奇跡	有時候	偶發性	突發性
不料	不圖	不虞	不意	意外	不測	竟然	奇怪	飛	竟	想不到	殊不知	出冷門	出乎意料	出乎意外	意料之外	出其不意	誰知	想得到	意想不到	驟起	始料不及	始料未及	不可捉摸
也許	或許	容許	或者	或	可能	恐怕	恐	想必	興許	說不定	或是	諒必	莫不	指不定	唯恐
大概	大略	大約	約莫	大致	大體	八成	光景	敢情	約	橫	蓋	備不住	粗粗	大體上	大致說來	大約摸	約摸
難道	莫非	莫不是	別是	豈	寧	難道說
不	非	匪	無	未	弗	勿	莫	休	毋	免	請勿	切莫
不用	甭	無須	並非	毫不	毫無	決不	絕不	休想	永不	不要
沒	沒有	未曾	未嘗	無	毋	罔	靡	莫	不曾	從不	從未	從未有過	尚未	一無	並未	尚無	從來不	從沒	絕非	遠非
四顧無人	無人
竭力	極力	盡力	一力	悉力	努力	大力	鼎力	全力	奮力	拼命	使勁	用勁	全力以赴	竭盡全力	不遺餘力	賣力	皓首窮經	用力	鉚勁	力竭聲嘶	努	著力	力圖	鼓足幹勁	開足馬力	耗竭	不竭	恪盡	矢志不渝	忙乎
儘量	不擇手段	狠命	竭盡	盡可能	盡力而為	盡其所有	傾心盡力	死命	玩命	拚命	盡心	盡心盡力	盡心盡意	拼命三郎	硬著頭皮	苦鬥
任意	肆意	隨意	恣意	任性	無度	自由	隨便	輕易	擅自	隨心所欲	不管三七二十一	隨隨便便	無限制	即興	人身自由	妄動	隨機
盡情	任情	忘情	縱情	痛快	暢快	暢	好好兒	敞開兒	自做主張	流連忘返	留連
胡亂	胡	亂	濫	混	瞎	妄	亂七八糟
特意	特地	特為	特別	專門	專誠	專程
故意	故	有意	蓄意	假意	成心	存心	有心	有意識	明知故問	明知故犯	特此	特有
順便	就便	趁便	乘便	順手	順帶	附帶	捎帶	捎帶腳兒	有意無意
隨口	順口	信口
隨手	順手	跟手	信手	就手
順路	順腳	順道
隨身	身上
無心	無意	誤	無意識	下意識	不知不覺	平空	潛意識	無形中
藉故	托故	假託	推託	藉口	假說	托詞	託辭
託病	稱病
無故	無端	憑空	平白	平白無故	無緣無故
執意	硬是	就是
只得	只好	只能	不得不	唯其如此
共同	協同	一同	一道	一起	一齊	一塊兒	一路	一頭	一併	聯合	合夥	夥同	夥	並	合	齊	共	同	旅	偕	合辦	齊聲	同步	同船	協	一塊	連袂	聯手	手把手	聯名	同台	連線	協辦	同機
分頭	分別	個別	各自	並立	獨家	各行其事	分級
獨自	單獨	獨立	獨力	獨	單身	單個兒	隻身一人	獨門
互相	相互	交互	相	互	彼此	互動	互為	競相	相互之間	並行
從中	居中	居間
親自	親身	切身	親	躬
親手	手
挨次	順次	依次	以次	次第	順序	相繼	逐一	一一	逐個	各個	挨個兒	曆	逐	挨個	挨家挨戶	挨門挨戶	逐項	逐條	梯次
輪流	輪番	輪班	輪換	交替	更迭	更替	輪崗
交叉	穿插	接力	陸續
迎頭	當頭	劈頭	一頭	迎面	劈臉	撲鼻
迎風	逆風	頂風
逕自	徑直	徑
直接	徑直	一直	直	第一手	直白
就地	當庭
間接	轉彎抹角	拐彎抹角
恰巧	剛巧	湊巧	可巧	碰巧	偏巧	趕巧	正巧	恰好	正好	剛好	可好	恰恰	剛剛	恰	剛	巧	正	適	適逢其會	無獨有偶	正要
幸虧	多虧	虧得	幸而	幸好	幸喜	難為	虧	幸	好在	正是
偏偏	偏巧	不巧	偏	獨獨
竟然	居然	竟自	甚至	竟	還	還是	甚至於	竟是
幾乎	差一點	差點兒	幾	殆
險些	險乎	險	差點
仍然	依然	仍舊	依舊	兀自	仍	還	還是	照舊	照例	照樣	援例	一仍舊貫	一如既往	依然如故	依然故我	如故	反之亦然
尚且	還	都	猶	且
索性	爽性	乾脆	簡直	一不做
畢竟	究竟	終究	到底	終歸	總歸	總	歸根結底	說到底	終竟
簡直	直	直截
固然	固	雖	雖然	誠然
反正	橫豎	橫	左右	左不過
實在	委實	著實	確實	的確	確乎	真個	當真	真正	真	確	委	洵	審	誠	誠然	真的	確確實實
果然	果真	果	果不其然
其實	實則	實在	實際	實際上	實質上	骨子裡	事實上	莫過於
不免	未免	難免	免不了	免不得	在所難免
莫如	莫若	不如
無怪	難怪	無怪乎	怪不得	怨不得
未嘗	何嘗	未始
毋寧	無寧	不如	與其	倒不如	與其說
寧可	寧肯	寧願	寧	情願
究竟	究	到底
不妨	無妨	何妨
千萬	萬萬	切切	斷斷	斷乎	斷然	絕對	切	絕	決	斷	純屬	絕對化
當然	自然	當	自	自是	本來	本	理所當然
卻	可	倒	也	倒是
還	尚
也	亦
反而	相反	反是	反倒	倒轉	反	倒
這樣	這麼	這麼樣	這麼著	如此	如斯	然	如此這般	這一來	諸如此類	這般
那樣	那麼	那麼著	恁	那麼樣	云云	那般
哪裡	哪	豈	何	烏	何在
怎樣	怎麼	怎的	怎麼樣	怎麼著	怎	哪樣	何如	何等	何許	什麼	如何	何以	哪	爭	安	焉	哪邊	哪些	什麼樣	咋樣	該當何論
為什麼	幹什麼	幹嗎	為何	為啥	何故	何以	怎麼	怎	胡	緣何
何不	盍	曷
向	朝	望	往	奔	為	於	朝向	朝著	通往	通向	徑向	向心	向陽
對	迎	當	沖	給	劈	照	面	面對	直面	相向
趨向	趨於	趨	鋒芒所向
背	坐	背靠	背著
在	於	當	以	每當
從	自	由	打	起	於	自從	打從	自打	從今
到	至	及	暨	迄	頂	屆	交
等到	待到	及至	趕	逮	迨
以至	直至	直到	截至	以至於
沿	緣	挨	順	本著	順著	沿著
跟	同	與	和
替	給	為	同
把	將	管	拿
比	比較	較	於	正如	可比
對於	對	於	對此
關於	有關	至於
為	以	為	為著	為了	以便
被	叫	讓	為	吃	於	給	受	深受
以	用	拿	將
由	歸
依靠	倚靠	指靠	依傍	靠	依	倚	因	乘	仗	仰	怙	恃	指	負	據	憑	賴	仰賴	依賴	倚賴	借重	倚重	借助	依仗	倚仗	憑仗	仰仗	仰承	依憑	憑依	憑藉	拄	依賴性	賴以生存	借助于	賴以
取給	吃	藉	憑堅	憑著	死仗	自恃
靠水吃水	靠海吃海
通過	經過	經	透過	由此
依照	按照	比照	遵照	遵循	照	仍	本	依	以	按	論	准	據	比如	循	遵	隨	按部就班	照說	以資	如約
按理	按說	按理說
依法	有法可依	有章可循
根據	依據	基於	因	沖	據悉
針對	對準	對	本著	照章	針對性	指向
趁	乘	迨	就	趁機	趁熱打鐵	趁早	趁著	乘機	乘勝	乘勢	乘隙	乘興	沖著	打鐵趁熱	就勢	隨著
有機可乘	有隙可乘
和	同	與	跟	暨	及	以及
連同	偕同	隨同	會同	夥同	及其
或者	或	抑或	還是	要麼	要	抑
並且	而且	同時	並且	而	又	以	與此同時	再就是	再者	還要
況且	而況	何況	況	加以	再說	再則	更何況	再者說
但是	只是	可是	不過	然而	可	然	而	但	然則	唯獨	而是
雖然	雖說	雖則	雖	則	儘管	儘管如此
即使	即若	即令	即或	即便	就算	就是	儘管	哪怕	不怕	縱使	縱令	縱然	縱	饒	即	就	便	雖	即使如此	不畏
既然	既是	既	既然如此
不但	非但	不單	不惟	不僅	不光	不只	不獨	非獨	非徒	豈但	不僅僅
何止	豈止
連	並
凡是	凡	是	大凡	舉凡
除了	除去	除開	除	除外	不外乎	除此之外	而外	除卻
除非	只有	惟有
若非	要不是
否則	要不	不然	要不然	不然	再不
庶幾	庶	才
如果	如其	如若	假若	設若	設或	倘或	倘若	假如	假設	假定	倘使	假使	設使	要是	若是	倘	比方	萬一	若	如	要	設	而	苟	倘	使	一旦	一經	倘然	若果	只要
那末	那麼	那	這就是說
因為	因	為	緣	以	坐	蓋	歸因於
由於	鑒於	由	出於	是因為
由此可見	有鑑於此
所以	因而	因此	故此	故而	從而	故	用	據此	於是	之所以	為此	就此	因故
如上所述	總的來說	由此看來	總的看	看來
不論	無論	不拘	不管	任憑	隨便	無	任	憑	管	任由	甭管	不論是	無論是	聽由
好歹	無論如何	不管怎樣	不顧	好賴
只管	儘管
於是	於是乎	遂	乃
此外	另外	除此以外	別有洞天	除此而外
哪堪	不堪
豈	怎	庸	怎麼	怎生
是不是	是否
的	之	底
然	乎	之乎者也
等等	之類
來著	來
過	了	罷	嘍
啊	啦	哪	哇	呀	呐
呢	者	嗎	麼	啊	也
嘍	嘞	咯	羅	了
哩	呢	咧
唄	嘛
喲	吧	啊	者	呵喲
嗎	呢	吧	乎	啊	否	歟	耶	邪	為	哉	也	也罷	與否
的話	吧	來說	以來
罷了	而已	便了	耳	如此而已
了	矣
哉	矣	兮	乎	嗚乎哀哉
喂	嘿	嗨
哎	喏	吠	唯
喳	啊	嗯
喔	噢	哦	啊
哼	嚇	好	呔
噯	嗯	唔
嘿	哈	哈哈
嗯	啊	哦	唔
嗨喲	哼唷
哎呀	哎喲	什麼	好傢伙	嘻	啊	嘿	呵	喲	呀	哎	呦	呵喲	咦
唉	噯	咳
哈哈	嘿嘿	哄	哈哈哈
撲哧	哧
嗚嗚	哇哇	呱呱
哇啦	哇哇	嘰裡呱啦
嘰嘰嘎嘎	嘰嘰喳喳	唧唧喳喳	嘁嘁喳喳	嘰裡咕嚕
喃喃	喁喁
咻咻	呼哧	吭哧
呼嚕	咕嘟	咕嚕	打鼾
噗	呼	哼哧
哇	噦	喀
啈啈	哼
咪咪	喵
啾啾	咬咬	嚦嚦	嘰	喳喳	唧唧喳喳
喔喔	喔
咕咕	咯咯
嘎嘎	呱呱	咻咻	嘎	咻
呼呼	嗚嗚	颯颯	蕭蕭	簌簌	瑟瑟	修修	颼颼
淅瀝	滴答	滴滴答答
刷刷	嘩嘩	嘩啦	嘩啦啦
隆隆	咕隆	隱隱	虺虺	轟隆	轟轟隆隆
烘烘	吱吱
嘩嘩	嘩啦	潺潺	活活	汩汩	淙淙	嗚咽	嘩啦啦
冬冬	咚咚
嘡嘡	錚錚	當
丁零	丁丁
丁東	玲玲	叮咚
丁當	鋃鐺	丁零當郎
噹啷	哐啷	哐
轆轆	軋	軋	咕隆
咯噔	噔	嘎登
吧唧	咕唧	吧噠
咿啞	咿呀	啞
哢嚓	吧	喀嚓	嘎巴	哢唑
嘎吱	咯吱	吱
沙沙	蕭瑟	沙沙沙
吱嘍	呀
篤篤	嗒嗒
梆	砰	乓	乒乓	乒	咣	乒乒乓乓
嗒嗒	噠
突突	怦	嘣	怦怦
劈啪	啪	劈劈啪啪
撲漉	撥剌	撲簌簌
喀噠	吧嗒	啪達
刷拉	砉	嚓
刺	哧	噝	嗖	噌	噝兒
咕咚	撲通	撲騰	撲	咚	嘭
嘟嘟	嗚	啼嗚	咕嘟嘟	嘟
轟隆	嗡嗡	轟	轟轟
早安	早
再見	再會	回見
失陪	少陪	告退	告辭	敬辭
慢走	好走	後會有期
請問	借問	借光	試問
指教	賜教	見教	請教	求教	討教	就教	不吝指教
候教	聆教
承蒙	承情	承	蒙	辱
賞光	賞臉	給面子
打擾	打攪	擾
勞駕	勞神	勞動	煩勞	麻煩	煩	勞	累	辛苦	分神	費心	費神	費事	難為	費盡周折	勞心
抱歉	對不起	對不住
久仰	久仰大名	久慕盛名
久違	少見
怠慢	失敬	失禮	不周	怠
失迎	有失遠迎
請便	聽便	自便	悉聽尊便
恭喜	恭賀	賀喜
託福	借光
謝謝	多謝	有勞
不謝	不敢當	別客氣	好說	彼此彼此
過獎	過譽
